相|あい|together, mutually|အတူတကွ၊ အပြန်အလှန်|noun
相変わらず|あいかわらず|as ever, as usual|အပြောင်းအလဲမရှိ၊ အမြဲတမ်း|adverb
愛想|あいそ|civility, courtesy|ဧည့်ဝတ်ပြုခြင်း၊ ယဉ်ကျေးမှု|noun
相対|あいたい|confrontation, facing|ရင်ဆိုင်ခြင်း၊ နှိုင်းယှဉ်ခြင်း|noun
間柄|あいだがら|relationship|ဆက်ဆံရေး|noun
愛憎|あいにく|unfortunately|ကံမကောင်းစွာ|adverb
合間|あいま|interval|အချိန်ကြား၊ ကြားဖြတ်|noun
曖昧|あいまい|vague, ambiguous|မရေရာသော၊ မှုန်ဝါးသော|adjective
敢えて|あえて|dare to do|ရဲရဲဝံ့ဝံ့|adverb
仰ぐ|あおぐ|to look up, to respect|မော့ကြည့်သည်၊ လေးစားသည်|verb
垢|あか|dirt, filth|အညစ်အကြေး|noun
亜科|あか|suborder, subfamily|အမျိုးခွဲ|noun
銅|あかがね|copper|ကြေးနီ|noun
証|あかし|proof, evidence|သက်သေ၊ အထောက်အထား|noun
赤字|あかじ|deficit|လိုငွေ၊ အရှုံး|noun
明かす|あかす|to reveal, to divulge|ဖော်ထုတ်သည်၊ ဖွင့်ဟသည်|verb
赤ちゃん|あかちゃん|baby, infant|ကလေးငယ်|noun
明白|あからさま|obvious, frank|ထင်ရှားသော၊ ပွင့်လင်းသော|adjective
赤らむ|あからむ|to become red, to blush|နီမြန်းသည်၊ ရှက်သည်|verb
明るい|あかるい|bright, cheerful|တောက်ပသော၊ ရွှင်လန်းသော|adjective
上がり|あがり|rise, completion|တက်လာခြင်း၊ ပြီးဆုံးခြင်း|noun
上がる|あがる|to rise, to go up|တက်သည်၊ မြင့်တက်သည်|verb
商人|あきうど|trader, merchant|ကုန်သည်|noun
空間|あきま|vacancy, empty room|လစ်လပ်နေရာ|noun
諦め|あきらめ|resignation, acceptance|စွန့်လွှတ်ခြင်း၊ လက်ခံခြင်း|noun
呆れる|あきれる|to be amazed, shocked|အံ့ဩသည်၊ အသည်းကွဲသည်|verb
悪|あく|evil, wickedness|မကောင်းမှု၊ ဆိုးညစ်မှု|noun
灰|あく|lye|ပြာရည်|noun
あくどい|あくどい|gaudy, vicious|စိုက်ထူသော၊ ရက်စက်သော|adjective
悪日|あくび|yawn|ချောင်းဟ|noun
明くる|あくる|next, following|နောက်လာမည့်|adjective
憧れ|あこがれ|yearning, longing|တမ်းတမှု၊ လိုချင်မှု|noun
顎|あご|chin|မေးစေ့|noun
麻|あさ|hemp, linen|ဆန်ပြာ|noun
明後日|あさって|day after tomorrow|သန်းဘောက်|noun
朝寝坊|あさねぼう|oversleeping|နံနက်ကြာကြာအိပ်ခြင်း|noun
浅ましい|あさましい|wretched, miserable|ကြောက်စရာ၊ ငိုစရာ|adjective
字|あざ|section of village|ရပ်ကွက်|noun
欺く|あざむく|to deceive|လှည့်ဖျားသည်၊ လိမ်ညာသည်|verb
鮮やか|あざやか|vivid, clear|တောက်ပသော၊ ရှင်းလင်းသော|adjective
あざ笑う|あざわらう|to sneer at, to ridicule|ကဲ့ရဲ့သည်၊ ပြက်ရယ်ပြုသည်|verb
味わい|あじわい|flavor, meaning|အရသာ၊ အဓိပ္ပာယ်|noun
東|あずま|east|အရှေ့|noun
焦る|あせる|to be in a hurry|အလျင်အမြန်ဖြစ်သည်|verb
彼処|あそこ|there|အဲဒီမှာ|pronoun
値|あたい|value, price|တန်ဖိုး၊ စျေးနှုန်း|noun
値する|あたいする|to be worth|တန်ဖိုးရှိသည်|verb
私|あたし|I (feminine)|ကျွန်မ|pronoun
当たり|あたり|hit, vicinity|ထိမှန်ခြင်း၊ အနီးဝန်းကျင်|noun
当たり前|あたりまえ|usual, natural|သာမန်၊ ပုံမှန်|adjective
他人|あだびと|stranger, outsider|အခြားသူ၊ တစ်ပါးသူ|noun
彼方此方|あちこち|here and there|နေရာအနှံ့|adverb
彼方|あちら|there, that|အဲဒီဘက်|pronoun
彼方此方|あちらこちら|here and there|နေရာအနှံ့|adverb
悪化|あっか|deterioration|ပိုဆိုးလာခြင်း|noun
呆気ない|あっけない|too quick, anticlimactic|လွန်းလွန်းမြန်မြန်|adjective
悪口|あっこう|abuse, slander|ကဲ့ရဲ့စကား|noun
あっさり|あっさり|easily, simply|လွယ်လွယ်ကူကူ၊ ရိုးရိုးလေး|adverb
圧迫|あっぱく|pressure, oppression|ဖိအားပေးခြင်း|noun
扱い|あつかい|treatment, handling|ဆက်ဆံခြင်း၊ ကိုင်တွယ်ခြင်း|noun
集まる|あつまる|to gather, to assemble|စုဝေးသည်|verb
誂える|あつらえる|to order|မှာယူသည်|verb
圧力|あつりょく|pressure, stress|ဖိအား|noun
当て|あて|aim, expectation|ရည်ရွယ်ချက်၊ မျှော်လင့်ချက်|noun
宛|あて|addressed to|သို့ပို့သည့်|noun
当て字|あてじ|substitute character|အစားထိုးစာလုံး|noun
当てはまる|あてはまる|to apply|သက်ဆိုင်သည်|verb
当てはめる|あてはめる|to apply, to adapt|အသုံးချသည်|verb
宛てる|あてる|to address|လိပ်စာရေးသည်|verb
跡継ぎ|あとつぎ|heir, successor|အမွေဆက်ခံသူ|noun
後回し|あとまわし|postponing|နောက်ကျခြင်း|noun
貴女|あなた|you (lady)|သင်|pronoun
彼の|あの|that|အဲဒီ|adjective
溢れる|あふれる|to overflow|လျှံသည်၊ ပြည့်လျှံသည်|verb
油絵|あぶらえ|oil painting|ဆီအရောင်ချယ်ရီ|noun
炙る|あぶる|to scorch, to roast|ဖုတ်သည်|verb
あべこべ|あべこべ|contrary, opposite|ပြောင်းပြန်|adjective
甘える|あまえる|to act like a spoiled child|အရင်းခံသည်|verb
甘口|あまくち|sweet flavor|ချို့ချို့|adjective
雨具|あまぐ|rain gear|မိုးကာပစ္စည်း|noun
天|あまつ|heavenly, imperial|ကောင်းကင်ဆိုင်ရာ|adjective
網|あみ|net, network|ပိုက်ကွန်|noun
天地|あめつち|heaven and earth|ကောင်းကင်နှင့်မြေ|noun
操る|あやつる|to manipulate|ခြယ်လှယ်သည်|verb
あやふや|あやふや|uncertain, vague|မသေချာသော|adjective
危ぶむ|あやぶむ|to fear, to doubt|ကြောက်ရွံ့သည်၊ သံသယရှိသည်|verb
過ち|あやまち|fault, error|အမှား၊ အပြစ်|noun
誤る|あやまる|to make a mistake|အမှားလုပ်သည်|verb
歩み|あゆみ|walking, progress|လမ်းလျှောက်ခြင်း၊ တိုးတက်မှု|noun
歩む|あゆむ|to walk|လမ်းလျှောက်သည်|verb
あら|あら|oh, ah|အင်း၊ အို|noun
予め|あらかじめ|beforehand, in advance|ကြိုတင်၍|adverb
荒らす|あらす|to lay waste, to damage|ဖျက်ဆီးသည်|verb
粗筋|あらすじ|outline, summary|အကျဉ်းချုပ်|noun
争い|あらそい|dispute, quarrel|အငြင်းပွား၊ ရန်ဖြစ်ခြင်း|noun
改まる|あらたまる|to be renewed|အသစ်ဖြစ်သည်|verb
荒っぽい|あらっぽい|rough, rude|ကြမ်းတမ်းသော|adjective
凡ゆる|あらゆる|all, every|အားလုံး|adjective
あられ|あられ|hail|မိုးသီး|noun
現われ|あらわれ|appearance, embodiment|ပေါ်ထွက်ခြင်း|noun
現われる|あらわれる|to appear|ပေါ်လာသည်|verb
有難う|ありがとう|thank you|ကျေးဇူးတင်ပါတယ်|noun
有様|ありさま|state, condition|အခြေအနေ|noun
有りのまま|ありのまま|as it is, frankly|ဖြစ်သလို|adverb
或る|ある|a certain|တစ်ခု၊ တစ်စုံတစ်ရာ|adjective
或いは|あるいは|or, possibly|သို့မဟုတ်|conjunction
彼此|あれこれ|this and that|ဒါတွေ၊ နာတွေ|pronoun
合わす|あわす|to join together|ပေါင်းသည်|verb
合わせ|あわせ|joint, combination|ပေါင်းစပ်ခြင်း|noun
慌ただしい|あわただしい|busy, hurried|အလျင်အမြန်ဖြစ်နေသော|adjective
慌てる|あわてる|to become confused|ကျပန်းဖြစ်သည်|verb
暗殺|あんさつ|assassination|လုပ်ကြံခြင်း|noun
暗算|あんざん|mental arithmetic|စိတ်ထဲတွက်ခြင်း|noun
暗示|あんじ|hint, suggestion|အရိပ်အမြွက်|noun
案じる|あんじる|to be anxious, to ponder|စိုးရိမ်သည်၊ စဉ်းစားသည်|verb
安静|あんせい|rest|အနားယူခြင်း|noun
案の定|あんのじょう|sure enough, as expected|မျှော်လင့်သည့်အတိုင်း|adverb
余り|あんまり|not very, remainder|မများ၊ ကျန်ရှိခြင်း|adverb
依|い|depending on|မှီခိုခြင်း|noun
良い|いい|good|ကောင်းသော|adjective
伊井|いい|Italy|အီတလီ|noun
否|いいえ|no|မဟုတ်ပါ|noun
いい加減|いいかげん|moderate, irresponsible|သင့်တင့်သော၊ တာဝန်မရှိသော|adjective
言い訳|いいわけ|excuse|ဆင်ခြေ|noun
家出|いえで|running away from home|အိမ်မှထွက်ပြေးခြင်း|noun
家主|いえぬし|landlord|အိမ်ရှင်|noun
如何|いかが|how|ဘယ်လို|adverb
生かす|いかす|to revive, to make use of|အသက်ရှင်စေသည်၊ အသုံးချသည်|verb
雷|いかずち|thunder|မိုးချုန်းသံ|noun
如何に|いかに|how, however|ဘယ်လို၊ ဘယ်လောက်|adverb
如何にも|いかにも|indeed, really|အမှန်တကယ်|adverb
怒り|いかり|anger|ဒေါသ|noun
怒る|いかる|to get angry|ဒေါသထွက်သည်|verb
歪む|いがむ|to be distorted|ကောက်သည်|verb
粋|いき|chic, stylish|လှပကျက်သရေရှိသော|adjective
域外|いきがい|outside the area|နယ်ပြင်ပ|noun
意気込む|いきごむ|to be enthusiastic|စိတ်အားထက်သန်သည်|verb
経緯|いきさつ|details, circumstances|အသေးစိတ်၊ အခြေအနေ|noun
行き違い|いきちがい|misunderstanding|နားလည်မှုလွဲခြင်း|noun
行き成り|いきなり|suddenly|ရုတ်တရက်|adverb
異議|いぎ|objection|ကန့်ကွက်ခြင်း|noun
いく|いく|to go, to come|သွားသည်|verb
軍|いくさ|war, battle|စစ်ပွဲ|noun
戦|いくさ|war, battle|စစ်ပွဲ|noun
育成|いくせい|rearing, training|ပြုစုပျိုးထောင်ခြင်း|noun
幾多|いくた|many|များစွာသော|adjective
活ける|いける|to arrange flowers|ပန်းစီသည်|verb
異見|いけん|different opinion|ကွဲပြားသောအမြင်|noun
意向|いこう|intention|ရည်ရွယ်ချက်|noun
移行|いこう|switching over|ကူးပြောင်းခြင်း|noun
いざ|いざ|now, well|ယခု၊ ကောင်းပြီ|adverb
碑|いしぶみ|stone monument|ကျောက်တိုင်|noun
衣装|いしょう|clothing, costume|ဝတ်စုံ|noun
意地|いじ|disposition, stubbornness|ခေါင်းမာမှု|noun
苛める|いじめる|to tease, to bully|နှိပ်စက်သည်|verb
移住|いじゅう|migration|ပြောင်းရွှေ့နေထိုင်ခြင်း|noun
弄る|いじる|to touch, to tamper with|ထိသည်၊ စမ်းသည်|verb
何れ|いずれ|where, which, anyway|ဘယ်မှာ၊ ဘယ်အရာ|pronoun
異性|いせい|the opposite sex|ဆန့်ကျင်ဘက်လိင်|noun
遺跡|いせき|historic ruins|ရှေးဟောင်းအကြွင်းအကျန်|noun
依然|いぜん|still, as yet|ဆဲ၊ အခု|adverb
依存|いそん|dependence|မှီခိုမှု|noun
委託|いたく|consign, entrust|အပ်နှင်းခြင်း|noun
悪戯|いたずら|prank, mischief|စော်ကားခြင်း|noun
頂|いただき|top of head, summit|ထိပ်ဖျား|noun
戴きます|いただきます|thank you for the meal|စားပွဲရှေ့ကျေးဇူးတင်စကား|noun
至って|いたって|very much, extremely|အလွန်|adverb
痛む|いたむ|to hurt, to feel pain|နာကျင်သည်|verb
痛める|いためる|to hurt, to injure|ထိခိုက်စေသည်|verb
炒める|いためる|to stir-fry|ကြော်သည်|verb
労る|いたわる|to pity, to care for|သနားသည်၊ ပြုစုသည်|verb
市|いち|market|ဈေး|noun
位地|いち|place, position|နေရာ၊ တည်နေရာ|noun
一々|いちいち|one by one|တစ်ခုချင်း|adverb
一概に|いちがいに|unconditionally|သတ်မှတ်ချက်မရှိ|adverb
一見|いちげん|at first glance|ပထမတွေ့ရှိရာတွင်|noun
一言|いちげん|single word|တစ်စကားတည်း|noun
一日|いちじつ|one day|တစ်ရက်|noun
一定|いちじょう|fixed, definite|သတ်မှတ်ထားသော|adjective
著しい|いちじるしい|remarkable|ထူးခြားသော|adjective
一同|いちどう|all present|တက်ရောက်သူအားလုံး|noun
一人|いちにん|one person|လူတစ်ဦး|noun
一部|いちぶ|one part, partly|တစ်စိတ်တစ်ပိုင်း|noun
一部分|いちぶぶん|a part|အစိတ်အပိုင်း|noun
一別|いちべつ|parting|ခွဲခွာခြင်း|noun
一面|いちめん|one side, front page|တစ်ဖက်၊ ရှေ့စာမျက်နှာ|noun
一目|いちもく|a glance|တစ်ချက်ကြည့်ခြင်း|noun
一様|いちよう|uniformity|တူညီမှု|noun
一律|いちりつ|uniformity|ညီညာမှု|noun
一連|いちれん|a series|အစဉ်အဆက်|noun
一括|いっかつ|all together|စုပေါင်း|noun
一気|いっき|in one gulp|တစ်ချက်တည်း|noun
一挙に|いっきょに|at a stroke|တစ်ချက်တည်းဖြင့်|adverb
一切|いっさい|all, everything|အားလုံး|noun
一心|いっしん|wholeheartedness|စိတ်တစ်ခုတည်း|noun
いっそ|いっそ|rather|လက်နဲ့၊ ထက်|adverb
一帯|いったい|a region, the whole place|ဒေသတစ်ခု|noun
一敗|いっぱい|one defeat|တစ်ကြိမ်ရှုံးခြင်း|noun
一変|いっぺん|complete change|လုံးလုံး လျားလျားပြောင်းလဲခြင်း|noun
何時|いつ|when|ဘယ်အချိန်|adverb
何時か|いつか|sometime, someday|တစ်ချိန်ချိန်၊ တစ်နေ့နေ့|adverb
何時でも|いつでも|at any time, always|ဘယ်အချိန်မဆို|adverb
何時の間にか|いつのまにか|before one knows|မသိမသာဖြစ်သွားခြင်း|adverb
何時までも|いつまでも|forever|ထာဝရ|adverb
何時も|いつも|always, usually|အမြဲ|adverb
意図|いと|intention, aim|ရည်ရွယ်ချက်|noun
営む|いとなむ|to carry on, to run|လုပ်ကိုင်သည်|verb
暇|いとま|free time, leisure|အားလပ်ချိန်|noun
異動|いどう|change|ပြောင်းလဲခြင်း|noun
挑む|いどむ|to challenge|စိန်ခေါ်သည်|verb
稲光|いなびかり|lightning|လျှပ်စီး|noun
古|いにしえ|antiquity|ရှေးခေတ်|noun
祈り|いのり|prayer|ဆုတောင်းခြင်း|noun
鼾|いびき|snoring|ဟန့်သံ|noun
今更|いまさら|now, at this late hour|ယခု၊ ဒီအချိန်မှာ|adverb
未だ|いまだ|not yet|မကြာသေး|adverb
移民|いみん|emigration, immigrant|ပြောင်းရွှေ့အခြေချသူ|noun
厭々|いやいや|unwillingly|မလိုလားစွာ|adverb
卑しい|いやしい|greedy, vulgar|တပ်မက်သော၊ ညစ်ညမ်းသော|adjective
いやに|いやに|awfully, terribly|အလွန်|adverb
厭やらしい|いやらしい|detestable|စက်ဆုပ်ရွံရှာဖွယ်|adjective
愈々|いよいよ|more and more, at last|ပို၍ပို၍၊ နောက်ဆုံး|adverb
意欲|いよく|will, desire|ဆန္ဒ|noun
苛々|いらいら|getting nervous, irritation|စိတ်လှုပ်ရှားခြင်း|noun
入口|いりくち|entrance|ဝင်ပေါက်|noun
衣料|いりょう|clothing|အဝတ်အထည်|noun
威力|いりょく|power, might|အာဏာ၊ စွမ်းအား|noun
入る|いる|to enter|ဝင်သည်|verb
衣類|いるい|clothes, clothing|အဝတ်အစား|noun
色々|いろいろ|various|အမျိုးမျိုး|adjective
異論|いろん|different opinion|ကွဲပြားသောအမြင်|noun
所謂|いわゆる|so-called|ဆိုခေါ်သော|adjective
印|いん|seal, stamp|တံဆိပ်|noun
員|いん|member|အဖွဲ့ဝင်|noun
印鑑|いんかん|seal, stamp|တံဆိပ်ခေါင်း|noun
陰気|いんき|gloom, melancholy|မှောင်မိုက်သော|adjective
隠居|いんきょ|retirement|အငြိမ်းစား|noun
上下|うえした|up and down|အပေါ်အောက်|noun
浮かぶ|うかぶ|to float|မျောပါသည်|verb
受かる|うかる|to pass an exam|စာမေးပွဲအောင်မြင်သည်|verb
含嗽|うがい|gargle|ပါးစပ်ဆေးသည်|noun
受け入れ|うけいれ|acceptance|လက်ခံခြင်း|noun
受け入れる|うけいれる|to accept|လက်ခံသည်|verb
受け継ぐ|うけつぐ|to inherit|အမွေဆက်ခံသည်|verb
受け付ける|うけつける|to be accepted|လက်ခံသည်|verb
受け止める|うけとめる|to catch, to react to|ခံယူသည်|verb
受け取り|うけとり|receipt|ပြေစာ|noun
受身|うけみ|passive|အပြုခံ|noun
動き|うごき|movement|လှုပ်ရှားမှု|noun
潮|うしお|tide|ရေတက်ရေကျ|noun
氏|うじ|family name|မျိုးနွယ်အမည်|noun
渦|うず|swirl|ရေလှိုင်း|noun
埋まる|うずまる|to be buried|မြှုပ်နှံသည်|verb
嘘つき|うそつき|liar|လိမ်ညာသူ|noun
打ち合わせ|うちあわせ|meeting, appointment|အစည်းအဝေး|noun
打ち合わせる|うちあわせる|to arrange|စီစဉ်သည်|verb
打ち切る|うちきる|to stop, to discontinue|ရပ်တန့်သည်|verb
打ち消し|うちけし|negation, denial|ငြင်းဆိုခြင်း|noun
打ち込む|うちこむ|to drive in, to devote oneself|စိုက်ထုတ်သည်၊ အထုတ်အချွန်းလုပ်သည်|verb
団扇|うちわ|fan|ပန်ကာ|noun
内訳|うちわけ|breakdown, classification|အသေးစိတ်ခွဲခြမ်းမှု|noun
訴え|うったえ|lawsuit, complaint|တရားစွဲခြင်း၊ တိုင်ကြားခြင်း|noun
鬱陶しい|うっとうしい|gloomy, depressing|စိတ်ညစ်စရာ|adjective
写し|うつし|copy|မိတ္တူ|noun
空ろ|うつろ|blank, empty|အလွတ်၊ ဗလာ|adjective
器|うつわ|bowl, vessel|အိုး၊ ခွက်|noun
雨天|うてん|rainy weather|မိုးရွာသောရာသီ|noun
腕前|うでまえ|ability, skill|စွမ်းရည်|noun
饂飩|うどん|udon noodles|ခေါက်ဆွဲ|noun
促す|うながす|to urge, to press|တိုက်တွန်းသည်|verb
唸る|うなる|to groan, to moan|ညည်းညူသည်|verb
自惚れ|うぬぼれ|conceit, hubris|မာန်မာနကြီးခြင်း|noun
甘い|うまい|delicious, skillful|အရသာရှိသော၊ ကျွမ်းကျင်သော|adjective
生まれつき|うまれつき|by nature, by birth|မွေးရာပါ|noun
海路|うみじ|sea route|ပင်လယ်လမ်း|noun
産む|うむ|to give birth|မွေးဖွားသည်|verb
埋め込む|うめこむ|to bury, to embed|မြှုပ်သည်|verb
梅干|うめぼし|dried plum|သစ်ချဉ်ခြောက်|noun
末|うら|top end|အဆုံး|noun
裏返し|うらがえし|inside out|ပြောင်းပြန်|noun
売り出し|うりだし|sale|ရောင်းချခြင်း|noun
売り出す|うりだす|to put on sale|ရောင်းချသည်|verb
潤う|うるおう|to be moist, to profit|စိုစွတ်သည်၊ အမြတ်ရသည်|verb
五月蝿い|うるさい|noisy, annoying|ဆူညံသော|adjective
売れ行き|うれゆき|sales|အရောင်းအဝယ်|noun
浮気|うわき|flighty, unfaithful|သစ္စာမရှိခြင်း|noun
上手|うわて|upper part, skillful|အပေါ်ပိုင်း၊ ကျွမ်းကျင်သော|noun
上回る|うわまわる|to exceed|ကျော်လွန်သည်|verb
植わる|うわる|to be planted|စိုက်ထားသည်|verb
運営|うんえい|management, operation|စီမံခန့်ခွဲမှု|noun
うんざり|うんざり|tedious, fed up|ငြီးငွေ့စရာ|adjective
運送|うんそう|shipping, transportation|ပို့ဆောင်ရေး|noun
運賃|うんちん|freight rates, fare|ပို့ဆောင်ခ|noun
云々|うんぬん|and so on|စသည်ဖြင့်|adverb
運搬|うんぱん|transport, carriage|သယ်ယူပို့ဆောင်ခြင်း|noun
運命|うんめい|fate, destiny|ကံကြမ္မာ|noun
運輸|うんゆ|transportation|ပို့ဆောင်ရေး|noun
運用|うんよう|making use of|အသုံးချခြင်း|noun
会|え|understanding|နားလည်မှု|noun
重|え|fold, layer|ထပ်|noun
えい|えい|ray (fish)|ငါးကျောက်ပုဿာ|noun
映写|えいしゃ|projection|မြင်ကွင်းပြသခြင်း|noun
英字|えいじ|English letter|အင်္ဂလိပ်စာလုံး|noun
衛生|えいせい|health, hygiene, sanitation|ကျန်းမာရေး|noun
映像|えいぞう|image, reflection|ပုံရိပ်|noun
英雄|えいゆう|hero|သူရဲကောင်း|noun
液|えき|liquid, fluid|အရည်|noun
役|えき|war, campaign|စစ်ပွဲ|noun
閲覧|えつらん|inspection, reading|ကြည့်ရှုခြင်း|noun
獲物|えもの|game, prey|သားကောင်|noun
襟|えり|collar, lapel|ကော်လာ|noun
縁|えん|chance, fate, relationship|အကြောင်းဆက်၊ တော်စပ်မှု|noun
塩|えん|salt|ဆား|noun
艶|えん|charming, glossy|တောက်ပသော|noun
園|えん|garden|ဥယျာဉ်|noun
円滑|えんかつ|smooth, harmonious|ချောမွေ့သော|adjective
縁側|えんがわ|veranda|လသာဆောင်|noun
沿岸|えんがん|coast, shore|ကမ်းရိုးတန်း|noun
婉曲|えんきょく|euphemistic, indirect|သွယ်ဝိုက်သော|adjective
演習|えんしゅう|practice, exercise|လေ့ကျင့်ခန်း|noun
演出|えんしゅつ|production, direction|ထုတ်လုပ်ခြင်း|noun
演じる|えんじる|to perform, to play|ကစားသည်၊ လုပ်ဆောင်သည်|verb
演ずる|えんずる|to perform|လုပ်ဆောင်သည်|verb
沿線|えんせん|along railway line|မီးရထားလိုင်းတစ်လျှောက်|noun
縁談|えんだん|marriage proposal|လက်ထပ်ကမ်းလှမ်းခြင်း|noun
遠方|えんぽう|distant place|ဝေးလံသောနေရာ|noun
円満|えんまん|harmony, perfection|ပြီးပြည့်စုံသော|adjective
尾|お|tail|အမြီး|noun
於|お|at, in|တွင်|particle
甥|おい|nephew|တူ(ယောက်ျားလေး)|noun
追い込む|おいこむ|to herd, to corner|ထောင့်ဖမ်းသည်|verb
美味しい|おいしい|delicious|အရသာရှိသော|adjective
追い出す|おいだす|to expel, to drive out|နှင်ထုတ်သည်|verb
於いて|おいて|at, in|တွင်|particle
お出でになる|おいでになる|to be (honorific)|ရှိသည် (ဂုဏ်ပြု)|verb
老いる|おいる|to age|အသက်ကြီးသည်|verb
負う|おう|to bear, to owe|ထမ်းရွက်သည်|verb
応急|おうきゅう|emergency|အရေးပေါ်|noun
黄金|おうごん|gold|ရွှေ|noun
黄色|おうしょく|yellow|အဝါရောင်|noun
応募|おうぼ|application|လျှောက်ထားခြင်း|noun
おおい|おおい|hey!|ဟေ့|noun
大方|おおかた|perhaps, almost all|ဖြစ်နိုင်သည်၊ အများစု|adverb
大柄|おおがら|large build|ကိုယ်လုံးကြီးသော|adjective
大げさ|おおげさ|exaggerated|ချဲ့ကားသော|adjective
大事|おおごと|serious matter|အရေးကြီးကိစ္စ|noun
大ざっぱ|おおざっぱ|rough, sketchy|ကြမ်းတမ်းသော|adjective
大筋|おおすじ|outline|အကျဉ်းချုပ်|noun
大空|おおぞら|sky|ကောင်းကင်|noun
大幅|おおはば|large scale, drastic|ကြီးမားသော|adjective
大水|おおみず|flood|ရေကြီးခြင်း|noun
公|おおやけ|official, public|တရားဝင်၊ လူသိရှင်ကြား|noun
お蔭|おかげ|thanks to|ကြောင့်|noun
お蔭様で|おかげさまで|thanks to you|သင့်ကြောင့်|noun
可笑しい|おかしい|strange, funny|ထူးဆန်းသော၊ ရယ်စရာ|adjective
犯す|おかす|to commit|ကျူးလွန်သည်|verb
侵す|おかす|to invade|ကျူးကျော်သည်|verb
お菜|おかず|side dish|ဟင်း|noun
臆病|おくびょう|cowardice|သူရဲဘောကြောက်မှု|noun
遅らす|おくらす|to delay|နှောင့်နှေးစေသည်|verb
遅れ|おくれ|delay|နောက်ကျခြင်း|noun
起こす|おこす|to raise, to wake|နှိုးသည်၊ ဖြစ်ပေါ်စေသည်|verb
行い|おこない|deed, conduct|အပြုအမူ|noun
厳か|おごそか|austere, majestic|ခမ်းနားသော|adjective
傲る|おごる|to be proud|မာန်မာနကြီးသည်|verb
長|おさ|chief, head|ခေါင်းဆောင်|noun
押さえる|おさえる|to restrain, to press down|နှိပ်သည်၊ ထိန်းသိမ်းသည်|verb
お先に|おさきに|before, ahead|ရှေ့ဦးစွာ|adverb
収まる|おさまる|to end, to settle|ပြီးဆုံးသည်၊ အခြေချသည်|verb
納まる|おさまる|to be obtained|ရရှိသည်|verb
治まる|おさまる|to be at peace|ငြိမ်းချမ်းသည်|verb
お産|おさん|childbirth|မွေးဖွားခြင်း|noun
教え|おしえ|teachings|သွန်သင်ချက်|noun
押し込む|おしこむ|to push into|တွန်းသွင်းသည်|verb
惜しむ|おしむ|to regret, to value|နောင်တရသည်|verb
お喋り|おしゃべり|chattering, talkative|စကားများသော|noun
お洒落|おしゃれ|fashionable|ခေတ်စားသော|adjective
押し寄せる|おしよせる|to push forward|ရှေ့တွန်းတက်လာသည်|verb
お祖父さん|おじいさん|grandfather|အဘိုး|noun
お邪魔します|おじゃまします|excuse me for disturbing|အနှောင့်အယှက်ဖြစ်မှာစိုးလို့|verb
雄|おす|male|အထီး|noun
お世辞|おせじ|flattery|ချော့မော့စကား|noun
襲う|おそう|to attack|တိုက်ခိုက်သည်|verb
遅くとも|おそくとも|at the latest|နောက်ဆုံးမှာတော့|adverb
恐らく|おそらく|perhaps|ဖြစ်နိုင်သည်|adverb
恐れ|おそれ|fear|ကြောက်ရွံ့မှု|noun
恐れ入る|おそれいる|to be filled with awe|ရိုသေလေးစားသည်|verb
お大事に|おだいじに|take care of yourself|ကိုယ့်ကိုယ်ကို ဂရုစိုက်ပါ|noun
煽てる|おだてる|to flatter|ချော့မော့သည်|verb
落ち込む|おちこむ|to fall into, to feel down|ကျဆင်းသည်၊ စိတ်ဓာတ်ကျသည်|verb
落ち着き|おちつき|calm, composure|တည်ငြိမ်မှု|noun
落ち葉|おちば|fallen leaves|ရွက်ကြွေ|noun
落ちる|おちる|to fall, to fail|ကျသည်၊ ရှုံးသည်|verb
おっかない|おっかない|frightening|ကြောက်စရာ|adjective
仰っしゃる|おっしゃる|to say (honorific)|ပြောသည် (ဂုဏ်ပြု)|verb
乙|おつ|strange, second|ထူးဆန်းသော၊ ဒုတိယ|adjective
お使い|おつかい|errand|လုပ်ငန်းခွင်|noun
お手上げ|おてあげ|all over, give up|လက်လျှော့သည်|noun
御手洗い|おてあらい|toilet, restroom|အိမ်သာ|noun
弟|おと|younger brother|ညီ|noun
落とす|おとす|to drop|ကျစေသည်|verb
訪れる|おとずれる|to visit|လည်ပတ်သည်|verb
大人しい|おとなしい|obedient, quiet|နားခံသော၊ တိတ်ဆိတ်သော|adjective
少女|おとめ|maiden, young lady|အပျိုကညာ|noun
お供|おとも|attendant|အပါအဝင်|noun
衰える|おとろえる|to decline, to weaken|အားနည်းသွားသည်|verb
おどおど|おどおど|hesitantly|တုန်လှုပ်စွာ|adverb
脅かす|おどかす|to threaten|ခြိမ်းခြောက်သည်|verb
脅す|おどす|to threaten|ခြိမ်းခြောက်သည်|verb
驚き|おどろき|surprise|အံ့အားသင့်မှု|noun
同い年|おないどし|same age|အသက်တူ|noun
女子|おなご|woman|အမျိုးသမီး|noun
お願いします|おねがいします|please|ကျေးဇူးပြု၍|noun
各|おのおの|each, every|တစ်ခုချင်း|adverb
自ずから|おのずから|naturally|သဘာဝအလျောက်|adverb
お早う|おはよう|good morning|မင်္ဂလာနံနက်ခင်းပါ|noun
お祖母さん|おばあさん|grandmother|အဖွား|noun
怯える|おびえる|to be frightened|ကြောက်ရွံ့သည်|verb
夥しい|おびただしい|abundant|များပြားလှသော|adjective
帯びる|おびる|to wear, to carry|ဝတ်ဆင်သည်၊ သယ်ဆောင်သည်|verb
覚え|おぼえ|memory|မှတ်ဉာဏ်|noun
御負け|おまけ|discount, extra|လျှော့စျေး၊ ဆောင်း|noun
お巡りさん|おまわりさん|policeman|ရဲ|noun
お宮|おみや|Shinto shrine|ဘုရားကျောင်း|noun
お襁褓|おむつ|diaper|အကြုံး|noun
お目出度う|おめでとう|congratulations|ဂုဏ်ပြု|noun
面|おも|face|မျက်နှာ|noun
思い付き|おもいつき|idea, suggestion|စိတ်ကူး|noun
面白い|おもしろい|interesting|စိတ်ဝင်စားဖွယ်|adjective
玩具|おもちゃ|toy|ကစားစရာ|noun
重なる|おもなる|main, important|အဓိက|adjective
趣|おもむき|meaning, grace|အဓိပ္ပာယ်၊ အလှအပ|noun
赴く|おもむく|to go, to proceed|သွားရောက်သည်|verb
重役|おもやく|director|ဒါရိုက်တာ|noun
重んじる|おもんじる|to respect, to honor|လေးစားသည်|verb
重んずる|おもんずる|to respect|လေးစားသည်|verb
お休み|おやすみ|good night, rest|အိပ်ချိန်ရောက်ပြီ|noun
お八|おやつ|snack|ဆာလေး|noun
凡そ|およそ|about, roughly|ခန့်|adverb
及び|および|and, as well as|နှင့်|conjunction
及ぶ|およぶ|to reach, to equal|ရောက်သည်၊ ညီသည်|verb
織|おり|weave|ရက်လုပ်ထားသော|noun
檻|おり|cage|လှောင်အိမ်|noun
折り返す|おりかえす|to turn back|ပြန်လှည့်သည်|verb
織物|おりもの|textile, fabric|အထည်|noun
織る|おる|to weave|ရက်သည်|verb
俺|おれ|I (male, informal)|ငါ|pronoun
愚か|おろか|foolish|မိုက်မဲသော|adjective
疎か|おろそか|neglect|လျစ်လျူရှုခြင်း|adjective
終わる|おわる|to finish|ပြီးဆုံးသည်|verb
音色|おんいろ|tone quality|အသံအရည်အသွေး|noun
温和|おんわ|gentle, mild|နူးညံ့သော|adjective
仮|か|temporary|ယာယီ|adjective
科|か|department|ဌာန|noun
個|か|piece, item|အခု|noun
下位|かい|low rank|အဆင့်နိမ့်|noun
階|かい|floor, story|ထပ်|noun
改悪|かいあく|deterioration|ပိုဆိုးလာခြင်း|noun
海運|かいうん|marine transportation|ပင်လယ်ပို့ဆောင်ရေး|noun
改革|かいかく|reform|ပြုပြင်ပြောင်းလဲမှု|noun
貝殻|かいがら|shell|ခရု|noun
階級|かいきゅう|class, rank|အဆင့်|noun
海峡|かいきょう|channel, strait|ရေလက်ကြား|noun
会見|かいけん|interview|တွေ့ဆုံခြင်း|noun
介護|かいご|nursing|သူနာပြုခြင်း|noun
開催|かいさい|holding a meeting|အစည်းအဝေးကျင်းပခြင်း|noun
回収|かいしゅう|collection, recovery|စုဆောင်းခြင်း|noun
改修|かいしゅう|repair|ပြုပြင်ခြင်း|noun
怪獣|かいじゅう|monster|ဘီလူး|noun
解除|かいじょ|cancellation|ဖျက်သိမ်းခြင်း|noun
回送|かいそう|forwarding|လွှဲပို့ခြင်း|noun
階層|かいそう|class, hierarchy|အဆင့်အတန်း|noun
開拓|かいたく|reclamation, pioneer|ဖွင့်လှစ်ခြင်း|noun
会談|かいだん|conference|ဆွေးနွေးပွဲ|noun
改定|かいてい|reform|ပြုပြင်ခြင်း|noun
改訂|かいてい|revision|ပြင်ဆင်ခြင်း|noun
街道|かいどう|highway|အဓိကလမ်းမ|noun
介入|かいにゅう|intervention|ဝင်ရောက်စွက်ဖက်ခြင်း|noun
開発|かいはつ|development|ဖွံ့ဖြိုးတိုးတက်မှု|noun
海抜|かいばつ|height above sea level|ပင်လယ်ရေမျက်နှာပြင်အထက်အမြင့်|noun
介抱|かいほう|nursing|သူနာပြုခြင်း|noun
解剖|かいぼう|dissection, autopsy|ခွဲစိတ်စစ်ဆေးခြင်း|noun
回覧|かいらん|circulation|လည်ပတ်ပေးခြင်း|noun
海流|かいりゅう|ocean current|သမုဒ္ဒရာရေစီးကြောင်း|noun
改良|かいりょう|improvement|တိုးတက်ကောင်းမွန်ခြင်း|noun
回路|かいろ|circuit|လျှပ်စစ်ပတ်လမ်း|noun
顧みる|かえりみる|to look back|နောက်ကြည့်သည်|verb
省みる|かえりみる|to reflect|သုံးသပ်သည်|verb
返る|かえる|to return|ပြန်သည်|verb
顔付き|かおつき|facial expression|မျက်နှာထား|noun
掲げる|かかげる|to publish, to put up|ဖော်ပြသည်၊ ချိတ်ဆွဲသည်|verb
踵|かかと|heel|ဖနောင့်|noun
係り|かかり|person in charge|တာဝန်ရှိသူ|noun
課外|かがい|extracurricular|သင်ရိုးညွှန်းတမ်းပြင်ပ|adjective
書き取り|かきとり|dictation|ခိုင်းရေးခြင်း|noun
書き取る|かきとる|to write down|မှတ်ရေးသည်|verb
掻き回す|かきまわす|to stir up|ရောသည်|verb
欠く|かく|to lack|ချို့တဲ့သည်|verb
角|かく|angle|ထောင့်|noun
核|かく|nucleus|နျူကလိယ|noun
格|かく|status, case|အဆင့်|noun
佳句|かく|beautiful passage|လှပသောစာပိုဒ်|noun
画|かく|stroke|မျဉ်းသား|noun
格差|かくさ|disparity|ကွာဟချက်|noun
拡散|かくさん|diffusion|ပျံ့နှံ့ခြင်း|noun
各種|かくしゅ|every kind|အမျိုးမျိုး|noun
隔週|かくしゅう|every other week|နှစ်ပတ်တစ်ကြိမ်|noun
確信|かくしん|conviction|ခိုင်မာသောယုံကြည်ချက်|noun
革新|かくしん|innovation|ဆန်းသစ်မှု|noun
確定|かくてい|decision|ဆုံးဖြတ်ခြင်း|noun
獲得|かくとく|acquisition|ရရှိခြင်း|noun
確保|かくほ|guarantee|အာမခံခြင်း|noun
革命|かくめい|revolution|တော်လှန်ရေး|noun
確立|かくりつ|establishment|တည်ထောင်ခြင်း|noun
賭け|かけ|betting, gamble|လောင်းကစား|noun
掛け|かけ|credit|အကြွေး|noun
駆け足|かけあし|running|ပြေး|noun
家計|かけい|household economy|အိမ်တွင်းစီးပွားရေး|noun
駆けっこ|かけっこ|foot race|ပြေးပြိုင်ပွဲ|noun
駆ける|かける|to run|ပြေးသည်|verb
賭ける|かける|to bet, to wager|လောင်းသည်|verb
ヶ月|かげつ|month counter|လ (အရေအတွက်)|noun
加工|かこう|manufacturing|ထုတ်လုပ်ခြင်း|noun
化合|かごう|chemical combination|ဓာတုပေါင်းစပ်ခြင်း|noun
嵩張る|かさばる|to be bulky|ကြီးမားသည်|verb
嵩む|かさむ|to pile up, to increase|တိုးပွားသည်|verb
風車|かざぐるま|windmill, pinwheel|လေသိုက်|noun
畏まりました|かしこまりました|certainly|ရပါတယ်|noun
華奢|かしゃ|delicate, slender|သိမ်မွေ့သော|adjective
箇所|かしょ|place, point|နေရာ|noun
火傷|かしょう|burn|မီးလောင်ခြင်း|noun
箇条書き|かじょうがき|itemized form|အချက်လိုက်စာရင်း|noun
噛る|かじる|to chew, to bite|ကိုက်သည်|verb
微か|かすか|faint, dim|အားနည်းသော|adjective
霞む|かすむ|to grow hazy|မှုန်ဝါးသည်|verb
化する|かする|to change into|ပြောင်းလဲသည်|verb
擦る|かする|to touch lightly|ထိသည်|verb
火星|かせい|Mars|အင်္ဂါဂြိုဟ်|noun
化石|かせき|fossil|ကျောက်ဖြစ်ရုပ်ကြွင်း|noun
河川|かせん|rivers|မြစ်များ|noun
化繊|かせん|synthetic fiber|အတု့အမျှင်|noun
過疎|かそ|depopulation|လူဦးရေလျော့နည်းခြင်း|noun
過多|かた|excess|ပိုလွန်ခြင်း|noun
難い|かたい|difficult|ခက်ခဲသော|adjective
片思い|かたおもい|unrequited love|တစ်ဖက်သတ်ချစ်ခြင်း|noun
敵|かたき|enemy, rival|ရန်သူ|noun
気質|かたぎ|spirit, temperament|စရိုက်လက္ခဏာ|noun
片言|かたこと|baby talk|ကလေးပြောစကား|noun
片付け|かたづけ|tidying up|သပ်ရပ်ခြင်း|noun
傾く|かたぶく|to incline, to slant|စောင်းသည်|verb
傾ける|かたむける|to incline, to tilt|စောင်းစေသည်|verb
固める|かためる|to harden|မာစေသည်|verb
偏る|かたよる|to be biased|တစ်ဖက်သတ်ဖြစ်သည်|verb
傍ら|かたわら|beside, while|အနားတွင်|noun
課題|かだい|subject, task|အလုပ်တာဝန်|noun
花壇|かだん|flower bed|ပန်းခြံ|noun
家畜|かちく|livestock|မွေးမြူရေးတိရစ္ဆာန်|noun
画期|かっき|epoch-making|ခေတ်သစ်ဖွင့်|adjective
活発|かっぱつ|active, vigorous|တက်ကြွသော|adjective
且つ|かつ|yet, and|ထို့အပြင်|conjunction
割|かつ|divide, cut|ခွဲသည်|verb
嘗て|かつて|once, ever|တစ်ချိန်က|adverb
日付|かづけ|date|ရက်စွဲ|noun
門|かど|gate|တံခါး|noun
叶う|かなう|to come true|အကောင်အထည်ဖော်သည်|verb
叶える|かなえる|to grant|ပြည့်စုံစေသည်|verb
金槌|かなづち|hammer|တူ|noun
鉄棒|かなぼう|iron rod|သံချောင်း|noun
可成|かなり|considerably|များစွာ|adverb
加入|かにゅう|joining|ပါဝင်ခြင်း|noun
金庫|かねぐら|safe, vault|ဘဏ္ဍာရေးခန်း|noun
予言|かねごと|prediction|ကြိုတင်ဟောကြားချက်|noun
兼ねて|かねて|simultaneously|တစ်ပြိုင်နက်|adverb
下番|かばん|going off duty|အလုပ်ပြန်ဆင်းခြင်း|noun
下品|かひん|inferior article|အရည်အသွေးနိမ့်ပစ္စည်း|noun
華美|かび|gaudy|စိမ်းစိုနေသော|adjective
花粉|かふん|pollen|ဝတ်မှုန်|noun
株式|かぶしき|stock|ရှယ်ယာ|noun
気触れる|かぶれる|to be influenced|လွှမ်းမိုးခံရသည်|verb
貨幣|かへい|money, currency|ငွေကြေး|noun
構え|かまえ|posture|ကိုယ်ဟန်အနေအထား|noun
構える|かまえる|to set up|ပြင်ဆင်သည်|verb
加味|かみ|seasoning|အရသာ|noun
噛み切る|かみきる|to bite off|ကိုက်ဖြတ်သည်|verb
過密|かみつ|crowded|လူစည်ကားသော|adjective
瓶|かめ|earthenware pot|အိုးမြေ|noun
かも知れない|かもしれない|may, might|ဖြစ်နိုင်သည်|verb
粥|かゆ|rice gruel|ဆန်ပြုတ်|noun
痒い|かゆい|itchy|ယားယံသော|adjective
揶揄う|からかう|to tease|ပြက်ရယ်ပြုသည်|verb
身体|からだ|body|ခန္ధာကိုယ်|noun
体付き|からだつき|body build|ခန္ధာဗီသဏ္ဌာန်|noun
絡む|からむ|to entangle|ရှုပ်ထွေးသည်|verb
借り|かり|borrowing|ချေးယူခြင်း|noun
下吏|かり|lower official|အရာရှိအဆင့်နိမ့်|noun
加留多|かるた|playing cards|ဖဲချပ်|noun
涸れる|かれる|to dry up|ခြောက်သွေ့သည်|verb
過労|かろう|overwork|အလုပ်များလွန်းခြင်း|noun
辛うじて|かろうじて|barely|ခဲယဉ်းစွာ|adverb
側|かわ|side|ဘက်|noun
可愛い|かわいい|cute|ချစ်စရာကောင်းသော|adjective
可愛がる|かわいがる|to love|ချစ်ခင်သည်|verb
可哀想|かわいそう|pitiful|သနားစရာ|adjective
可愛らしい|かわいらしい|lovely|ချစ်စရာလေး|adjective
交わす|かわす|to exchange|ဖလှယ်သည်|verb
代わる|かわる|to take the place of|အစားထိုးသည်|verb
代わる代わる|かわるがわる|alternately|အလှည့်ကျ|adverb
乾|かん|heaven, emperor|ကောင်းကင်၊ ဧကရာဇ်|noun
管|かん|pipe, tube|ပိုက်|noun
幹|かん|trunk|ပင်စည်|noun
冠|かん|crown|သရဖူ|noun
観|かん|look, appearance|အမြင်|noun
館|かん|hall, building|အဆောက်အအုံ|noun
簡易|かんい|simplicity|ရိုးရှင်းမှု|noun
感慨|かんがい|deep emotion|စိတ်ခံစားချက်နက်နဲခြင်း|noun
寒気|かんき|cold|အေးခြင်း|noun
簡潔|かんけつ|concise|တိုတောင်းသော|adjective
還元|かんげん|reduction|ပြန်လည်ရရှိခြင်း|noun
刊行|かんこう|publication|ထုတ်ဝေခြင်း|noun
慣行|かんこう|customary practice|ထုံးတမ်းစဉ်လာ|noun
勧告|かんこく|advice, recommendation|အကြံပြုချက်|noun
看護|かんご|nursing|သူနာပြုခြင်း|noun
漢語|かんご|Chinese word|တရုတ်စကားလုံး|noun
換算|かんさん|conversion|ပြောင်းလဲတွက်ချက်ခြင်း|noun
監視|かんし|observation|စောင့်ကြည့်ခြင်း|noun
慣習|かんしゅう|custom|ထုံးတမ်း|noun
観衆|かんしゅう|audience|ပရိသတ်|noun
干渉|かんしょう|interference|ဝင်ရောက်စွက်ဖက်ခြင်း|noun
感触|かんしょく|feeling, sensation|ထိတွေ့မှု|noun
肝心|かんじん|essential|အရေးကြီးဆုံး|adjective
歓声|かんせい|cheer|ကြွေးကြော်သံ|noun
感染|かんせん|infection|ကူးစက်ခြင်း|noun
幹線|かんせん|main line|အဓိကလမ်း|noun
関税|かんぜい|customs, tariff|အကောက်ခွန်|noun
簡素|かんそ|simplicity|ရိုးရှင်းမှု|noun
観点|かんてん|point of view|အမြင်ထောင့်|noun
感度|かんど|sensitivity|ထိခိုက်လွယ်မှု|noun
幹部|かんぶ|management staff|အုပ်ချုပ်ရေးအဖွဲ့|noun
勘弁|かんべん|pardon|ခွင့်လွှတ်ခြင်း|noun
完璧|かんぺき|perfection|ပြီးပြည့်စုံမှု|noun
感無量|かんむりょう|deep feeling|နက်နဲသောခံစားချက်|noun
勧誘|かんゆう|invitation|ဖိတ်ခေါ်ခြင်း|noun
関与|かんよ|participation|ပါဝင်ခြင်း|noun
慣用|かんよう|common use|အသုံးများသော|noun
寛容|かんよう|tolerance|သည်းခံမှု|noun
観覧|かんらん|viewing|ကြည့်ရှုခြင်း|noun
官僚|かんりょう|bureaucrat|ရာထူးကြီးအရာရှိ|noun
慣例|かんれい|custom|ထုံးတမ်း|noun
還暦|かんれき|60th birthday|အသက် ၆၀ ပြည့်မွေးနေ့|noun
貫禄|かんろく|dignity|ဂုဏ်သိက္ခာ|noun
緩和|かんわ|relief|သက်သာခြင်း|noun
蓋|がい|cover, lid|အဖုံး|noun
街|がい|street, quarters|လမ်း၊ ရပ်ကွက်|noun
外貨|がいか|foreign money|နိုင်ငံခြားငွေ|noun
外観|がいかん|appearance|အပြင်ပန်း|noun
外相|がいしょう|foreign minister|နိုင်ငံခြားရေးဝန်ကြီး|noun
害する|がいする|to injure, to harm|ထိခိုက်စေသည်|verb
概説|がいせつ|outline|အကျဉ်းချုပ်|noun
該当|がいとう|corresponding|သက်ဆိုင်သော|noun
街頭|がいとう|in the street|လမ်းပေါ်တွင်|noun
概念|がいねん|concept|အယူအဆ|noun
外来|がいらい|imported|တင်သွင်းသော|noun
概略|がいりゃく|outline|အကျဉ်းချုပ်|noun
学芸|がくげい|arts and sciences|အနုပညာနှင့်သိပ္ပံ|noun
学士|がくし|university graduate|တက္ကသိုလ်ဘွဲ့ရ|noun
学説|がくせつ|theory|သီအိုရီ|noun
楽譜|がくふ|musical score|တေးရေးစာအုပ်|noun
学歴|がくれき|academic background|ပညာရေးမှတ်တမ်း|noun
崖|がけ|cliff|ချောက်ကမ်း|noun
雅致|がち|elegance|လှပကျက်သရေ|noun
がっくり|がっくり|heartbroken|စိတ်ပျက်စရာ|adverb
合唱|がっしょう|chorus|သံပြိုင်|noun
がっしり|がっしり|solidly|ခိုင်မာစွာ|adverb
合致|がっち|agreement|သဘောတူညီမှု|noun
がっちり|がっちり|solidly built|ခိုင်ခံ့စွာတည်ဆောက်ထားသော|adverb
月日|がっぴ|date|ရက်စွဲ|noun
合併|がっぺい|merger|ပေါင်းစည်းခြင်း|noun
がる|がる|to feel|ခံစားသည်|verb
側|がわ|side|ဘက်|noun
癌|がん|cancer|ကင်ဆာ|noun
眼科|がんか|ophthalmology|မျက်စိဆေးကု|noun
眼球|がんきゅう|eyeball|မျက်လုံး|noun
眼鏡|がんきょう|spectacles|မျက်မှန်|noun
頑固|がんこ|stubborn|ခေါင်းမာသော|adjective
願書|がんしょ|written application|လျှောက်လွှာ|noun
頑丈|がんじょう|solid, sturdy|ခိုင်မာသော|adjective
岩石|がんせき|rock|ကျောက်တုံး|noun
元年|がんねん|first year|ပထမနှစ်|noun
贋物|がんぶつ|counterfeit|အတုအယောင်|noun
元来|がんらい|originally|မူလက|adverb
生|き|pure, raw|သန့်ရှင်းသော|adjective
期|き|period, time|ကာလ|noun
企画|きかく|planning|စီစဉ်ခြင်း|noun
規格|きかく|standard|စံနှုန်း|noun
着飾る|きかざる|to dress up|အလှဆင်သည်|verb
器官|きかん|organ|ကိုယ်တွင်းအင်္ဂါ|noun
季刊|きかん|quarterly|သုံးလပတ်|noun
危害|きがい|injury, harm|ထိခိုက်မှု|noun
気兼ね|きがね|hesitance|ငြီးငွေ့မှု|noun
気軽|きがる|cheerful|ရွှင်လန်းသော|adjective
危機|きき|crisis|အကြပ်အတည်း|noun
聞き取り|ききとり|listening comprehension|နားထောင်နားလည်ခြင်း|noun
効き目|ききめ|effect|အာနိသင်|noun
帰京|ききょう|returning to Tokyo|တိုကျိုပြန်ခြင်း|noun
基金|ききん|fund|ရန်ပုံငွေ|noun
棄権|きけん|abstention|ရပ်နားခြင်း|noun
喜劇|きげき|comedy|ဟာသပြဇာတ်|noun
起源|きげん|origin|မူလအစ|noun
機構|きこう|mechanism|ယန္တရား|noun
既婚|きこん|married|လက်ထပ်ပြီးသော|adjective
記載|きさい|entry|မှတ်တမ်းတင်ခြင်း|noun
気障|きざ|affectation|အသွင်ဆောင်ခြင်း|noun
兆し|きざし|signs, omen|လက္ခဏာ|noun
兆|きざし|signs|လက္ခဏာ|noun
軋む|きしむ|to creak|ကတ်သံမြည်သည်|verb
気象|きしょう|weather|ရာသီဥတု|noun
期日|きじつ|fixed date|သတ်မှတ်ရက်|noun
記述|きじゅつ|description|ဖော်ပြချက်|noun
奇数|きすう|odd number|မကိန်း|noun
築く|きずく|to build|တည်ဆောက်သည်|verb
傷付く|きずつく|to be wounded|ဒဏ်ရာရသည်|verb
規制|きせい|regulation|စည်းမျဉ်း|noun
汽船|きせん|steamship|ရေနွေးငွေ့သင်္ဘော|noun
寄贈|きそう|donation|လှူဒါန်းခြင်း|noun
貴族|きぞく|noble|မင်းမျိုးမင်းနွယ်|noun
鍛える|きたえる|to train|လေ့ကျင့်သည်|verb
来る|きたる|to come|လာမည့်|verb
気立て|きだて|disposition|စရိုက်|noun
きちっと|きちっと|exactly|တိကျစွာ|adverb
几帳面|きちょうめん|methodical|စနစ်ကျသော|adjective
切っ掛け|きっかけ|chance, start|အခွင့်အရေး|noun
きっかり|きっかり|exactly|အတိအကျ|adverb
喫茶|きっさ|tea drinking|လက်ဖက်ရည်သောက်ခြင်း|noun
きっちり|きっちり|precisely|တိကျစွာ|adverb
屹度|きっと|surely|သေချာစွာ|adverb
きっぱり|きっぱり|clearly|ရှင်းလင်းစွာ|adverb
規定|きてい|regulation|စည်းမျဉ်း|noun
起点|きてん|starting point|အစမှတ်|noun
軌道|きどう|orbit|ပတ်လမ်း|noun
甲|きのえ|first|ပထမ|noun
気配|きはい|indication|လက္ခဏာ|noun
規範|きはん|model, standard|စံပြ|noun
気品|きひん|refinement|သိက္ခာ|noun
気風|きふう|character|စရိုက်လက္ခဏာ|noun
起伏|きふく|undulation|တက်ကျ|noun
規模|きぼ|scale|စကေး|noun
気まぐれ|きまぐれ|whim|စိတ်ကူး|noun
生真面目|きまじめ|too serious|လွန်းလွန်းအလေးအနက်ထားသော|adjective
期末|きまつ|end of term|သင်တန်းအဆုံး|noun
決まり悪い|きまりわるい|feeling awkward|အဆင်မပြေစရာ|adjective
決まる|きまる|to be decided|ဆုံးဖြတ်သည်|verb
記名|きめい|signature|လက်မှတ်ထိုးခြင်း|noun
脚色|きゃくしょく|dramatization|ဇာတ်သိမ်းခြင်း|noun
脚本|きゃくほん|scenario|ဇာတ်ညွှန်း|noun
客観|きゃっかん|objective|ဓမ္မဓိဌာန်|noun
規約|きやく|agreement|သဘောတူညီချက်|noun
救援|きゅうえん|relief|ကယ်ဆယ်ရေး|noun
休学|きゅうがく|suspension from school|ကျောင်းရပ်နားခြင်း|noun
究極|きゅうきょく|ultimate|အဆုံးစွန်|noun
窮屈|きゅうくつ|narrow, tight|ကျဉ်းမြောင်းသော|adjective
球根|きゅうこん|bulb|မြေအောက်ပင်စည်|noun
救済|きゅうさい|relief|ကယ်တင်ခြင်း|noun
給食|きゅうしょく|school lunch|ကျောင်းနေ့လည်စာ|noun
給仕|きゅうじ|office boy|ရုံးလုပ်သား|noun
休戦|きゅうせん|truce|စစ်ရပ်နားခြင်း|noun
旧知|きゅうち|old friend|ရှေးမိတ်ဆွေ|noun
宮殿|きゅうでん|palace|နန်းတော်|noun
窮乏|きゅうぼう|poverty|ဆင်းရဲမွဲတေမှု|noun
丘陵|きゅうりょう|hill|တောင်ကုန်း|noun
共|きょう|both, together|အတူတူ|noun
供|きょう|offer|ပူဇော်ခြင်း|noun
驚異|きょうい|wonder|အံ့ဖွယ်|noun
教員|きょういん|teaching staff|ဆရာဆရာမများ|noun
教科|きょうか|subject|ဘာသာရပ်|noun
協会|きょうかい|association|အသင်း|noun
共感|きょうかん|sympathy|စာနာမှု|noun
共学|きょうがく|coeducation|ယောကျာ်းမိန်းမတူတူတက်ရောက်ခြင်း|noun
協議|きょうぎ|conference|ဆွေးနွေးပွဲ|noun
教訓|きょうくん|lesson|သင်ခန်းစာ|noun
境遇|きょうぐう|environment|ပတ်ဝန်းကျင်အခြေအနေ|noun
強行|きょうこう|forcing|အတင်းအကျပ်လုပ်ခြင်း|noun
強硬|きょうこう|firm|ခိုင်မာသော|adjective
凶作|きょうさく|bad harvest|ရိတ်သိမ်းမှုညံ့ဖျင်းခြင်း|noun
共産|きょうさん|communism|ကွန်မြူနစ်|noun
教材|きょうざい|teaching materials|သင်ကြားရေးပစ္စည်း|noun
教習|きょうしゅう|training|သင်တန်း|noun
郷愁|きょうしゅう|nostalgia|မြေပြန့်တမ်းတမှု|noun
教職|きょうしょく|teaching profession|ဆရာဝန်ထမ်း|noun
享受|きょうじゅ|enjoyment|ခံစားခြင်း|noun
興じる|きょうじる|to amuse oneself|ပျော်ရွှင်သည်|verb
強制|きょうせい|compulsion|အတင်းအကျပ်ပြုခြင်း|noun
共存|きょうそん|coexistence|အတူတကွရှင်သန်ခြင်း|noun
姉妹|きょうだい|sisters|မောင်နှမများ|noun
協調|きょうちょう|cooperation|ပူးပေါင်းဆောင်ရွက်ခြင်း|noun
協定|きょうてい|agreement|သဘောတူညီချက်|noun
脅迫|きょうはく|threat|ခြိမ်းခြောက်ခြင်း|noun
共鳴|きょうめい|resonance|ပဲ့တင်ထပ်ခြင်း|noun
郷里|きょうり|hometown|မွေးရပ်ဇာတိ|noun
強烈|きょうれつ|intense|ပြင်းထန်သော|adjective
共和|きょうわ|republicanism|သမ္မတနိုင်ငံရေး|noun
曲|きょく|tune|သီချင်း|noun
局限|きょくげん|limit|ကန့်သတ်ချက်|noun
極端|きょくたん|extreme|အစွန်းရောက်သော|adjective
居住|きょじゅう|residence|နေထိုင်ခြင်း|noun
拒絶|きょぜつ|refusal|ငြင်းပယ်ခြင်း|noun
拒否|きょひ|rejection|ပယ်ချခြင်း|noun
許容|きょよう|permission|ခွင့်ပြုခြင်း|noun
距離|きょり|distance|အကွာအဝေး|noun
寄与|きよ|contribution|ပံ့ပိုးကူညီမှု|noun
清らか|きよらか|pure|သန့်ရှင်းသော|adjective
気楽|きらく|at ease|သက်သာသော|adjective
煌びやか|きらびやか|gorgeous|တောက်ပလှသော|adjective
切り|きり|limits, end|အဆုံး|noun
桐|きり|paulownia|သစ်ပင်မျိုး|noun
切り替える|きりかえる|to change|ပြောင်းသည်|verb
気流|きりゅう|atmospheric current|လေစီးကြောင်း|noun
奇麗|きれい|pretty, clean|လှသော၊ သန့်ရှင်းသော|adjective
切れ目|きれめ|break, gap|အပိုင်းအခြား|noun
際|きわ|edge, verge|အစွန်း|noun
木綿|きわた|cotton|ဝါ|noun
極めて|きわめて|extremely|အလွန်|adverb
僅|きん|small quantity|အနည်းငယ်|noun
近眼|きんがん|nearsightedness|မျက်စိတိုခြင်း|noun
緊急|きんきゅう|urgent, pressing, emergency|အရေးပါသော|adjective
近々|きんきん|nearness, before long|မကြ့သည်|adverb
近郊|きんこう|suburbs, outskirts|နယ်နိမ့်ဒေသ|noun
均衡|きんこう|equilibrium, balance|တူညီမှု|noun
近視|きんし|shortsightedness|အဝေးမမြင်ရ|noun
禁じる|きんじる|to prohibit|ခွင့်မပြုရ|verb
禁ずる|きんずる|to forbid, to suppress|ပိတ်ပင်ရ|verb
勤勉|きんべん|industry, diligence|အလုပ်စိုက်ခြင်း|noun
勤務|きんむ|service, duty, work|ရုံးအလုပ်|noun
禁物|きんもつ|taboo, forbidden thing|ခွင့်မပြုလိုဖွယ်ရာ|noun
勤労|きんろう|labor, exertion, diligent service|လုပ်ဆောင်ချက်|noun
議案|ぎあん|legislative bill|နိုင်ငံရေးအဆိုစာ|noun
戯曲|ぎきょく|play, drama|ပွဲစီစဉ်ချက်|noun
議決|ぎけつ|resolution, decision, vote|အဆုံးအဖြတ်|noun
議事堂|ぎじどう|Diet building|အစည်းအဝေးခန်း|noun
犠牲|ぎせい|sacrifice|အသက်စွန့်ခွာခြင်း|noun
偽造|ぎぞう|forgery, falsification, fabrication, counterfeiting|သုံးမည်တည့်တည်း|noun
議題|ぎだい|topic of discussion, agenda|ဆွေးနွေးမည့်အရာ|noun
技能|ぎのう|technical skill, ability, capacity|အနုပညာ|noun
逆転|ぎゃくてん|sudden change, reversal, turn-around|ပြောင်းလဲမှု|noun
行|ぎょう|line, row, verse|အတန်း|noun
業者|ぎょうしゃ|trader, merchant|ကုန်သည်|noun
行政|ぎょうせい|administration|အုပ်ချုပ်ရန်|noun
業績|ぎょうせき|achievement, performance, results, work, contribution|ရလဒ်|noun
業務|ぎょうむ|business, affairs, duties, work|အလုပ်|noun
玉|ぎょく|king (shogi)|အရှင်|noun
漁船|ぎょせん|fishing boat|ငါးဖမ်းသင်္ဘော|noun
漁村|ぎょそん|fishing village|ငါးဖမ်းရွာ|noun
義理|ぎり|duty, sense of duty, honor, decency, courtesy|အကျိုးကျေးဇူး|noun
疑惑|ぎわく|doubt, misgivings, distrust, suspicion|သံသယ|noun
吟味|ぎんみ|testing, scrutiny, careful investigation|စူးစမ်းရှာဖွေချက်|noun
区|く|ward, district, section|ခရိုင်|noun
食い違う|くいちがう|to cross each other, to run counter to, to differ|ကွဲပြားမှု|verb
空腹|くうふく|hunger|ခိုက်ဆာမှု|noun
区画|くかく|division, section, compartment, boundary|ခွဲခြားမှု|noun
区間|くかん|section, distance|အကွာအဝေး|noun
茎|くき|stalk|အခြင်း|noun
区切り|くぎり|an end, a stop, punctuation|အဆုံး|noun
潜る|くぐる|to drive, to pass through, to evade, to hide, to dive|ဖြတ်သန်းရ|verb
種々|くさぐさ|variety|အမျိုးမျိုး|noun
嚏|くしゃみ|sneeze|နှာခေါင်းအသစ်|noun
旧事|くじ|past events, bygones|အင်္ဂါရပ်|noun
籤引|くじびき|lottery, drawn lot|ကံစီမံခန်း|noun
擽ぐったい|くすぐったい|ticklish|တုံးတုံးမြဲ|adjective
草臥れる|くたびれる|to get tired, to wear out|ပန်းလျက်|verb
下らない|くだらない|good-for-nothing, stupid, trivial|အစွဲမရ|adjective
件|くだん|example, precedent, the usual, the said|ထုံးစံ|noun
口ずさむ|くちずさむ|to hum something, to sing to oneself|စကားမှုတ်ခြင်း|verb
嘴|くちばし|beak, bill|နှာခေါင်း|noun
朽ちる|くちる|to rot|အစုပ်အစုံးရ|verb
くっきり|くっきり|distinctly, clearly, boldly|တစ်ခြင်းတစ်သည်|adverb
屈折|くっせつ|bending, indentation, refraction|ကောက်မြည်မှု|noun
くっ付く|くっつく|to adhere to, to keep close to|အလွတ်ပူးပေါင်း|verb
くっ付ける|くっつける|to attach|တွဲဆက်ရ|verb
覆す|くつがえす|to overturn, to upset, to overthrow|လှန်ချလိုက်ရ|verb
諄い|くどい|verbose, importunate, heavy|ခက်သည်|adjective
国境|くにざかい|national or state border|နိုင်ငံတကာ|noun
首飾り|くびかざり|necklace|လည်ဆွဲ|noun
首輪|くびわ|necklace, choker|လည်ဆွဲ|noun
組み合わせ|くみあわせ|combination|ပေါင်းစပ်ချက်|noun
組み合わせる|くみあわせる|to join together, to combine|ပေါင်းစည်းရ|verb
組み込む|くみこむ|to insert, to include, to cut in|အသုံးပြုရ|verb
蔵|くら|warehouse, cellar, magazine, granary|ကျေးဇူးလုံ|noun
苦しめる|くるしめる|to torment, to harass, to inflict pain|ဝေဒနာပေးရ|verb
包む|くるむ|to be engulfed in, to wrap up, to tuck in|စည်းကုပ်ရ|verb
呉れ呉れも|くれぐれも|repeatedly, sincerely, earnestly|အကျင်းအကျေး|adverb
呉れる|くれる|to give, to let one have, to do for one|အပ်နှံရ|verb
玄人|くろうと|expert, professional, geisha|ကျွမ်းကျင်သူ|noun
黒字|くろじ|balance in the black|အမြတ်|noun
君主|くんしゅ|ruler, monarch|မင်းသည်|noun
愚痴|ぐち|idle complaint, grumble|စကားရည်|noun
ぐっと|ぐっと|firmly, fast, much, more|အင်္ဂါ|adverb
ぐらい|ぐらい|approximately|လောက်|adverb
群|ぐん|group|အုပ်စုံ|noun
軍艦|ぐんかん|warship, battleship|စစ်သင်္ဘော|noun
群集|ぐんしゅう|crowd, throng, mob, multitude|ကိုယ်စုံ|noun
軍事|ぐんじ|military affairs|စစ်ရေး|noun
軍備|ぐんび|armaments, military preparations|စစ်တပ်|noun
軍服|ぐんぷく|military or naval uniform|စစ်ယူနီဖောင်း|noun
刑|けい|penalty, sentence, punishment|ဒဏ်ခတ်ချက်|noun
頃|けい|time, about, toward, approximately|အခါ|noun
傾|けい|lean, incline|လည်ပတ်ခြင်း|noun
系|けい|system, lineage, group|အဖြစ်အစည်း|noun
経過|けいか|passage, expiration, progress|အဆက်အစပ်|noun
軽快|けいかい|rhythmical, casual, light, nimble|ပေါ့ပါးသည်|adjective
警戒|けいかい|warning, admonition, vigilance|သတိထား|noun
計器|けいき|meter, gauge|ကိရိယာ|noun
契機|けいき|opportunity, chance|အခွင့်အလမ်း|noun
敬具|けいぐ|Sincerely yours|ရိုသေလေးစားမှု|noun
軽減|けいげん|abatement|လျော့ချခြင်း|noun
掲載|けいさい|appearance, article in paper|ထုတ်ဝေမှု|noun
傾斜|けいしゃ|inclination, slant, slope, bevel|စောင်းအစောင်း|noun
形成|けいせい|formation|ပုံစံခြင်း|noun
形勢|けいせい|condition, situation, prospects|အခြေအနေ|noun
軽率|けいそつ|rash, thoughtless, careless, hasty|လျစ်လျူရှုမှု|adjective
携帯|けいたい|carrying something|ယူဆောင်ခြင်း|noun
形態|けいたい|form, shape, figure|ပုံသဏ္ဍာန်|noun
刑罰|けいばつ|judgement, penalty, punishment|ဒဏ်ချက်|noun
経費|けいひ|expenses, cost, outlay|ခြင်းခြင်း|noun
警部|けいぶ|police inspector|ရဲအုပ်|noun
軽蔑|けいべつ|scorn, disdain|အန္တရာယ်|verb
経歴|けいれき|personal history, career|အလုပ်အကိုင်|noun
経路|けいろ|course, route, channel|လမ်းကြောင်း|noun
汚す|けがす|to disgrace, to dishonour|အညစ်ချရ|verb
汚らわしい|けがらわしい|filthy, unfair|အညစ်အကြေး|adjective
汚れ|けがれ|uncleanness, impurity, disgrace|အညစ်|noun
汚れる|けがれる|to get dirty, to become dirty|ညစ်ရ|verb
獣|けだもの|beast, brute|သတ္တုဆီးတန်း|noun
吝嗇|けち|stinginess, miser, miserliness|ကိုယ်ကျန်းခြင်း|noun
結核|けっかく|tuberculosis|ဆန္ဒအကြင်းအကုန်|noun
血管|けっかん|blood vessel|သွေးကြောင်း|noun
決行|けっこう|doing with resolve, carrying out|ဆုံးဖြတ်ခြင်း|noun
決算|けっさん|balance sheet, settlement of accounts|အငွေချေမှု|noun
決勝|けっしょう|decision of a contest, finals|နောက်ဆုံးပွဲ|noun
結晶|けっしょう|crystal, crystallization|ကြေးမုံ|noun
結成|けっせい|formation|စည်းမုံရ|verb
結束|けっそく|union, unity|ပေါင်းစည်းခြင်း|noun
傑|けつ|excellence|ထူးချွန်သည်|noun
決意|けつい|decision, determination|အဆုံးအဖြတ်|noun
決議|けつぎ|resolution, vote, decision|အဆုံးအဖြတ်|noun
結合|けつごう|combination, union|ပေါင်းစည်းမှု|noun
決断|けつだん|decision, determination|ဆုံးဖြတ်ခြင်း|noun
欠乏|けつぼう|want, shortage, famine|အလွန်အကျွံ|noun
蹴飛ばす|けとばす|to kick away, to kick off, to kick|ရိုက်နှက်ရ|verb
貶す|けなす|to speak ill of|အန္တရာယ်တင်ရ|verb
煙たい|けむたい|smoky, feeling awkward|ယိုင်သည်|adjective
煙る|けむる|to smoke|မီးခိုးထွက်ရ|verb
家来|けらい|retainer, retinue, servant|ကျေးဇူး|noun
けれど|けれど|but, however|သို့သော်|adverb
圏|けん|sphere, circle, range|ဒေသ|noun
権|けん|authority, the right to do something|အခွင့်အရေး|noun
権威|けんい|authority, power, influence|အာဏာ|noun
兼業|けんぎょう|side line, second business|ဘက်သုံးအလုပ်|noun
権限|けんげん|power, authority, jurisdiction|အခွင့်အရေး|noun
健在|けんざい|in good health, well|ကျန်းမာသည်|adjective
懸賞|けんしょう|offering prizes, reward|ဆုလွှာ|noun
検事|けんじ|public prosecutor|ရဲခွင့်ပြုသူ|noun
健全|けんぜん|health, soundness, wholesome|ကျန်းမာသည်|adjective
見地|けんち|point of view|အမြင်|noun
賢明|けんめい|wisdom, intelligence, prudence|ဥစ္စာ|adjective
倹約|けんやく|thrift, economy, frugality|သိုဆည်းခြင်း|noun
兼用|けんよう|multi-use, combined use|အသုံးပြုခြင်း|noun
権力|けんりょく|power, authority, influence|အာဏာ|noun
劇団|げきだん|troupe, theatrical company|ပွဲတွင်း|noun
激励|げきれい|encouragement|စိတ်ဓာတ်|noun
月謝|げっしゃ|monthly tuition fee|လစာ|noun
げっそり|げっそり|being disheartened, losing weight|အလေးလျော့သည်|adverb
月賦|げっぷ|monthly installment|လလဲအခါ|noun
下痢|げり|diarrhoea|အူအစာ|noun
原|げん|original, primitive, primary, fundamental|မူလ|noun
原形|げんけい|original form, base form|မူလပုံစံ|noun
現行|げんこう|present, current, in operation|လက်ရှိ|adjective
原作|げんさく|original work|မူလလုပ်ဆောင်ချက်|noun
原子|げんし|atom|အမည်းအလယ်|noun
元首|げんしゅ|ruler, sovereign|မင်းသည်|noun
原書|げんしょ|original document|မူလစာတမ်း|noun
減少|げんしょう|decrease, reduction, decline|လျော့ကျခြင်း|noun
現場|げんじょう|actual spot, scene|ကျေးရွာ|noun
元素|げんそ|chemical element|အခြင်းအခြင်း|noun
原則|げんそく|principle, general rule|အခြေခံသတ်မှတ်ချက်|noun
現像|げんぞう|developing (film)|ပုံထုတ်ခြင်း|noun
現地|げんち|actual place, local|ဒေသခံ|adjective
限定|げんてい|limit, restriction|သတ်မှတ်ခြင်း|noun
原点|げんてん|origin, starting point|နေရာ|noun
原典|げんてん|original (text)|မူလစာတမ်း|noun
減点|げんてん|subtract, give a demerit|အမှတ်လျော့ခြင်း|noun
原爆|げんばく|atomic bomb|အက်တမ်炸弾|noun
原文|げんぶん|the text, original|မူလစာသားများ|noun
厳密|げんみつ|strict, close|မတ်တတ်ခိုင်လုံသည်|adjective
原油|げんゆ|crude oil|အကြမ်းဖျင်းဆီ|noun
言論|げんろん|discussion|အမူအရာ|noun
故|こ|the late (deceased)|လူကျေးဆုံးသည်|noun
戸|こ|counter for houses|အိမ်အရေအတွက်|noun
児|こ|child, the young of animals|ကလေး|noun
巨|こ|big, large, great|ကြီးမားသည်|adjective
恋する|こいする|to fall in love with, to love|အချစ်ဆန်ရ|verb
溝|こう|ditch, drain|ချိုင့်|noun
校|こう|school, proof|ကျောင်း|noun
好意|こうい|good will, favor, courtesy|ကျေးဇူး|noun
行為|こうい|act, deed, conduct|အကျင်း|noun
行員|こういん|bank clerk|ဘဏ်ခန်းမအလုပ်သည်|noun
交易|こうえき|trade, commerce|ကုန်သွယ်ရ|noun
公演|こうえん|public performance|မြေးမြာမြာခွင့်ပြုမှု|noun
後悔|こうかい|regret, repentance|အလျှောက်ခြင်း|noun
公開|こうかい|presenting to the public|အများသူငှာ|noun
航海|こうかい|sail, voyage|ပင်လယ်ခရီးထွက်ခြင်း|noun
工学|こうがく|engineering|အင်ဂျင်နီယာ|noun
皇居|こうきょ|Imperial Palace|ရုပ်နှုန်း|noun
好況|こうきょう|prosperous conditions|ကြီးထွားမှု|noun
抗議|こうぎ|protest, objection|ကန့်ကားမှု|noun
鉱業|こうぎょう|mining industry|သတ္တုတူးဖော်ရ|noun
興業|こうぎょう|industrial enterprise|လုပ်ငန်းစီမံခန်း|noun
高原|こうげん|tableland, plateau|ကုန်းတွင်း|noun
煌々と|こうこうと|brilliantly, brightly|တောက်ပသည်|adverb
考古学|こうこがく|archaeology|အစဉ်အကျေးဇူး|noun
交互|こうご|mutual, reciprocal, alternate|တစ်ခြင်းတစ်ခြင်း|adjective
工作|こうさく|work, construction, handicraft|လုပ်ဆောင်ချက်|noun
耕作|こうさく|cultivation, farming|စိုက်ခင်းအလုပ်|noun
鉱山|こうざん|mine (ore)|သတ္တုတူးဖော်ခြင်း|noun
講習|こうしゅう|short course, training|သင်တန်းအတန်း|noun
交渉|こうしょう|negotiations, discussions|တွေ့ဆုံမှု|noun
高尚|こうしょう|high, noble, refined, advanced|မြတ်မြတ်မြုံ|adjective
行進|こうしん|march, parade|ကျော်လွှားခြင်း|noun
香辛料|こうしんりょう|spices|အသီးအသီး|noun
口述|こうじゅつ|verbal statement|ကျမ်းအဆိုအဆို|noun
控除|こうじょ|subsidy, deduction|အကျိုးခံစားခြင်း|noun
向上|こうじょう|elevation, rise, improvement|ကြီးထွားခြင်း|noun
降水|こうすい|rainfall, precipitation|မိုးရည်|noun
洪水|こうずい|flood|ရေလျှံမှု|noun
公然|こうぜん|open, public, official|သိသာတင်ဆက်မှု|adjective
抗争|こうそう|dispute, resistance|အငြင်းအခုံ|noun
構想|こうそう|plan, plot, idea, conception|လုပ်ငန်းအစည်းအရုံ|noun
拘束|こうそく|restriction, restraint|ကန့်သတ်ခြင်း|noun
後退|こうたい|retreat, backspace|ကျဆုံးခြင်း|noun
光沢|こうたく|brilliance, polish, lustre|တောက်ပမှု|noun
公団|こうだん|public corporation|အများသူငှာအဖွဲ့|noun
好調|こうちょう|favourable, promising, satisfactory|အကောင်းမွန်သည်|adjective
口頭|こうとう|oral|စကားအဆိုအဆို|adjective
講読|こうどく|reading, translation|ဖတ်ခြင်း|noun
購読|こうどく|subscription|စာအုပ်ယူခြင်း|noun
購入|こうにゅう|purchase, buy|ဝယ်ယူခြင်း|verb
公認|こうにん|official recognition, authorization|အများသူငှာအသိအသည်း|noun
光熱費|こうねつひ|cost of fuel and light|လျှပ်စစ်လျှပ်ညွှန်း|noun
荒廃|こうはい|ruin|ဆုံးရှုံးခြင်း|noun
購買|こうばい|purchase, buy|ဝယ်ယူခြင်း|noun
好評|こうひょう|popularity, favorable reputation|ကောင်းမွန်သောအကျင်းအကွင်း|noun
交付|こうふ|delivering, furnishing|အပ်နှံခြင်း|verb
降伏|こうふく|capitulation, surrender|လက်နစ်ခြင်း|noun
興奮|こうふん|excitement, stimulation, agitation|အရှင်လှုံ့ဆော်ခြင်း|noun
公募|こうぼ|public appeal, public contribution|အများတွင်ဆန္ဒခွင့်ပြုခြင်း|noun
巧妙|こうみょう|ingenious, skillful, clever, deft|လိမ္မာသည်|adjective
公用|こうよう|government business, public use|အများသူငှာသုံးစွဲခြင်း|noun
小売|こうり|retail|လည်လည်ဆည်း|noun
効率|こうりつ|efficiency|လုပ်ဆောင်မှု|noun
公立|こうりつ|public (institution)|အများသူငှာ|adjective
小柄|こがら|short (build)|ငယ်ငယ်တူးတူး|adjective
小切手|こぎって|cheque, check|ငွေလက်မှတ်|noun
国産|こくさん|domestic products|မြန်မာ|adjective
国定|こくてい|state-sponsored, national|အစိုးရအတည်ပြု|adjective
国土|こくど|realm|နိုင်ငံ|noun
告白|こくはく|confession, acknowledgement|ကိုယ်တိုင်အသိအလျှောက်|noun
国防|こくぼう|national defence|အုပ်ချုပ်ခြင်း|noun
国有|こくゆう|national ownership|အစိုးရပိုင်ဆိုင်မှု|noun
国連|こくれん|U.N., United Nations|အမေရိကန်ကုလသမဂ္ဂ|noun
漕ぐ|こぐ|to row, to scull, to pedal|အရီးဖြန်းခြင်း|verb
焦げ茶|こげちゃ|black tea|အနက်အနက်|noun
個々|ここ|individual, one by one|တစ်ခြင်းတစ်ခြင်း|adjective
箇箇|ここ|individual, separate|တစ်ခြင်းတစ်ခြင်း|adjective
心地|ここち|feeling, sensation, mood|ခံစားချက်|noun
心得|こころえ|knowledge, information|သိကျွမ်းမှု|noun
心掛け|こころがけ|readiness, intention, aim|သည်သည်တည်းဝယ်ခြင်း|noun
心掛ける|こころがける|to bear in mind, to aim to do|ရည်ညွှန်းခြင်း|verb
志|こころざし|will, intention, motive|အလိုအကြိုက်|noun
志す|こころざす|to plan, to intend, to aspire to|မျှော်လင့်ခြင်း|verb
心強い|こころづよい|heartening, reassuring|အားထုတ်ခြင်း|adjective
心細い|こころぼそい|helpless, forlorn, hopeless|စုံတွေးမှု|adjective
試み|こころみ|trial, experiment|စမ်းသပ်ခြင်း|noun
試みる|こころみる|to try, to test|စမ်းသပ်ရ|verb
快い|こころよい|pleasant, agreeable|ကျေးဇူးတင်ခြင်း|adjective
凝らす|こごらす|to freeze, to congeal|အခြင်းအခြင်း|verb
凝る|こごる|to congeal, to freeze|အခြင်းအခြင်း|verb
拵える|こしらえる|to make, to manufacture|စည်းမုံရ|verb
孤児|こじ|orphan|အဖအမမဲ့ကလေး|noun
拗れる|こじれる|to get complicated, to grow worse|ရှုံးခြင်း|verb
故人|こじん|the deceased, old friend|လူကျေးဆုံးသည်|noun
梢|こずえ|treetop|သစ်ပင်ထိပ်|noun
個性|こせい|individuality, personality, idiosyncrasy|အစုံအလင်|noun
戸籍|こせき|census, family register|မိသားစုမှတ်တမ်း|noun
小銭|こぜに|coins, small change|သေးငွေ|noun
固体|こたい|solid body|ကြားကျန်သည်|noun
答え|こたえ|answer, response|အဖြေ|noun
堪える|こたえる|to bear, to stand, to endure|သည့်တည်းခြင်း|verb
火燵|こたつ|table with heater|စာပုံစုံ|noun
古代|こだい|ancient times|ရှေးဟောင်းအခါ|noun
こだわる|こだわる|to fuss over, to be particular about|အမုန်းအကြိုက်|verb
誇張|こちょう|exaggeration|ကျယ်လွင်အုပ်ခြင်း|noun
滑稽|こっけい|funny, humorous, comical|ရယ်စရာ|adjective
国交|こっこう|diplomatic relations|နိုင်ငံတကာ|noun
骨董品|こっとうひん|curio|အဟောင်းပစ္စည်း|noun
骨|こつ|knack, skill|သတ္တုအထွက်|noun
固定|こてい|fixation|တည်ဆောက်ခြင်း|noun
事柄|ことがら|matter, thing, affair|အရာအနည်း|noun
悉く|ことごとく|altogether, entirely|လုံးလုံးဝဝ|adverb
言伝|ことづて|declaration, hearsay|ကမ်းလှမ်းချက်|noun
殊に|ことに|especially, above all|အထူးသဖြင့်|adverb
事によると|ことによると|depending on the circumstances|အခြေအနေအလျောက်|adverb
孤独|こどく|isolation, loneliness, solitude|အ혼်ယုံ|noun
粉々|こなごな|in very small pieces|အမှုန်မှုန်|adverb
此の|この|this|ဤ|adverb
この間|このあいだ|the other day, lately, recently|လွန်ခဲ့တဲ့နေ့|noun
この頃|このごろ|recently|လာလာခဲ့တဲ့နေ့|noun
好ましい|このましい|nice, likeable, desirable|နှစ်ခြင်းစိတ်ခြင်း|adjective
個別|こべつ|particular case|တစ်ခြင်းတစ်သည်|noun
零す|こぼす|to spill|လွှင့်ပြောင်းခြင်း|verb
零れる|こぼれる|to overflow, to spill|ရေထည့်ခြင်း|verb
細やか|こまやか|friendly|မိတ်ဆက်ခြင်း|adjective
混む|こむ|to be crowded|ကျေးရွာယုံခြင်း|verb
込める|こめる|to include, to put into|အသုံးပြုခြင်း|verb
篭る|こもる|to seclude oneself, to be confined in|အိုးအိမ်သည်|verb
固有|こゆう|characteristic, peculiar, inherent|ကိုယ်ကျန်းခြင်း|adjective
雇用|こよう|employment, hire|အလုပ်အကိုင်|noun
暦|こよみ|calendar, almanac|ရက်စွဲ|noun
堪える|こらえる|to bear, to stand, to endure|သည့်တည်းခြင်း|verb
孤立|こりつ|isolation, helplessness|လူမဲ့သည်|noun
懲りる|こりる|to learn by experience, to be disgusted with|သင်ခန်းစာခြင်း|verb
此れ|これ|this|ဤ|pronoun
此れ等|これら|these|ဒီတွေ|pronoun
魂|こん|soul, spirit|ဝိညာဉ်|noun
根気|こんき|patience, perseverance, energy|စိတ်ဖိုးမြင့်မှု|noun
根拠|こんきょ|basis, foundation|အခြေခံ|noun
混血|こんけつ|mixed race, mixed parentage|ရောများစုံတွေ့ခြင်း|noun
昆虫|こんちゅう|insect, bug|တစ်ခွက်|noun
根底|こんてい|root, basis, foundation|အခြေခြင်း|noun
混同|こんどう|confusion, mixing, merger|ကွဲပြားခြင်း|noun
今日は|こんにちは|hello, good day|မဂ္ဂလာ|noun
今晩は|こんばんは|good evening|ညဆိုင်း|noun
根本|こんぽん|origin, source, foundation, root|အခြေခြင်း|noun
御|ご|go-, honourable|အလေးအနက်|noun
語彙|ごい|vocabulary, glossary|အကျင်းအကွင်း|noun
濠|ごう|moat|ကျေးရွာ|noun
業|ごう|Buddhist karma|ကမ္မ|noun
号|ごう|number, issue|အမှတ်ည|noun
合意|ごうい|agreement, consent, mutual understanding|သဘောတူညီမှု|noun
合議|ごうぎ|consultation, conference|အစည်းအဝေး|noun
強気|ごうぎ|great, grand|အားလုံးသည်|adjective
合成|ごうせい|synthesis, composition, synthetic|ပေါင်းစည်းမှု|noun
護衛|ごえい|guard, convoy, escort|အကာအကွယ်|noun
語句|ごく|words, phrases|စကားအုပ်စုံ|noun
極楽|ごくらく|paradise|အကောင်းအသိုက်|noun
ご苦労様|ごくろうさま|Thank you very much for your|ကုန်းကုန်းလုပ်ခြင်း|noun
語源|ごげん|word root, word derivation, etymology|စကားကုန်းခြင်း|noun
誤差|ごさ|error|အမှားအယွင်း|noun
ご座います|ございます|to be (polite), to exist|ရှိခြင်း|verb
ご馳走|ごちそう|feast, treating|စားအကျ|noun
ご馳走さま|ごちそうさま|feast|စားအကျ|noun
毎|ごと|each respectively|တစ်ခြင်းတစ်သည်|adverb
碁盤|ごばん|Go board|ကွေ့ပွဲ|noun
ご無沙汰|ごぶさた|not writing or contacting for a while|အမြည်းအခါ|noun
誤魔化す|ごまかす|to deceive, to falsify, to misrepresent|လိမ်လည်ခြင်း|verb
御免ください|ごめんください|May I come in?|ခွင့်ပြုချက်|noun
御免なさい|ごめんなさい|I beg your pardon, excuse me|တောင်းပန်ခြင်း|noun
御覧なさい|ごらんなさい|please look, please try to do|ကြည့်ရှုခြင်း|verb
佐|さ|help|ကူညီခြင်း|noun
再|さい|re-, again, repeated|ပြန်လည်|adverb
差異|さい|difference, disparity|ကွဲပြားမှု|noun
歳|さい|age|အသက်|noun
再会|さいかい|another meeting, meeting again, reunion|ပြန်တွေ့ဆုံခြင်း|noun
災害|さいがい|calamity, disaster, misfortune|သဘာဝဒဏ်|noun
細菌|さいきん|bacillus, bacterium, germ|အဏုမျ|noun
細工|さいく|work, craftsmanship, tactics, trick|ချည်ဆွဲခြင်း|noun
採掘|さいくつ|mining|တူးဖော်ခြင်း|noun
採決|さいけつ|vote, roll call|မဲမြ== အဆိုအဆို|noun
再建|さいけん|rebuilding, reconstruction, rehabilitation|ပြုပြင်ခြင်း|noun
再現|さいげん|reappearance, reproduction, return, revival|ပြန်သည်ခြင်း|noun
採算|さいさん|profit|အမြတ်|noun
採集|さいしゅう|collecting, gathering|စုဆောင်းခြင်း|noun
再生|さいせい|playback, regeneration, resuscitation|ပြန်လည်ဖြစ်လျက်|noun
最善|さいぜん|the very best|အကောင်းဆုံး|noun
採択|さいたく|adoption, selection, choice|ရွေးချယ်ခြင်း|noun
再発|さいはつ|return, relapse, reoccurrence|ပြန်လည်ဖြစ်စေခြင်း|noun
栽培|さいばい|cultivation|စိုက်ခင်းခြင်း|noun
細胞|さいぼう|cell (biology)|အလူအဆ|noun
採用|さいよう|use, adopt|အသုံးပြုခြင်း|verb
遮る|さえぎる|to interrupt, to intercept, to obstruct|အပ်ရှောင်ခြင်း|verb
囀る|さえずる|to sing, to chirp, to twitter|အငီးအဆိုခြင်း|verb
冴える|さえる|to be clear, to be serene, to be cold|အပြတ်အသတ်သည်|verb
竿|さお|rod, pole|ကြိုးအုပ်ခြင်း|noun
栄える|さかえる|to prosper, to flourish|အကြီးအထွေထွေ|verb
杯|さかずき|wine cups|သုံးခွက်|noun
逆立ち|さかだち|handstand, headstand|ခေါင်းအောက်|noun
逆上る|さかのぼる|to go back, to go upstream, to make retroactive|ပြန်လည်သည်ခြင်း|verb
盛る|さかる|to prosper, to flourish, to copulate|အကြီးအထွေထွေ|verb
差額|さがく|balance, difference, margin|သူခွဲခြားမှု|noun
下がる|さがる|to hang down, to abate, to retire, to fall|လျော့ကျခြင်း|verb
一昨昨日|さきおととい|two days before yesterday|သုံးနေ့အရှေ့|noun
先に|さきに|before, earlier than, ahead, beyond|အရှေ့အရှေ့|adverb
詐欺|さぎ|fraud, swindle|လိမ်ခြင်း|noun
作|さく|a work, a harvest|အဆိုအဆို|noun
策|さく|plan, policy|အစီအစဉ်|noun
柵|さく|fence, paling|အုပ်စုံ|noun
削減|さくげん|cut, reduction, curtailment|လျော့ချခြင်း|noun
錯誤|さくご|mistake|အမှားအယွင်း|noun
作戦|さくせん|military or naval operations, tactics, strategy|စစ်တန်းအစီအစဉ်|noun
作物|さくぶつ|literary work|စိုက်ခင်းဖြစ်ပွားမှု|noun
叫び|さけび|shout, scream, outcry|အသံကြီးခြင်း|noun
裂ける|さける|to split, to tear, to burst|ကွဲခွါခြင်း|verb
捧げる|ささげる|to lift up, to give, to offer, to consecrate|ဆုံးမတင်ခြင်း|verb
差し掛かる|さしかかる|to come near to, to approach|ပြီးခဲ့ခြင်း|verb
指図|さしず|instruction, mandate|အညွှန်းအစီကမ်း|noun
差し出す|さしだす|to present, to submit, to tender, to hold out|တင်ခွင့်ပြုခြင်း|verb
差し支える|さしつかえる|to interfere, to hinder, to become impeded|အနံ့အဆေးခြင်း|verb
差し引く|さしひく|to deduct|လျော့နုတ်ခြင်း|verb
些事|さじ|something small or petty, trifle|အငယ်တည|noun
授ける|さずける|to grant, to award, to teach|ပေးခြင်း|verb
嘸|さぞ|I am sure, certainly, no doubt|သမုတ်သည်|adverb
定まる|さだまる|to become settled, to be fixed|တည်ဆောက်ခြင်း|verb
定める|さだめる|to decide, to establish, to determine|သတ်မှတ်ခြင်း|verb
錯覚|さっかく|optical illusion, hallucination|မြင်မှားခြင်း|noun
早急|さっきゅう|urgent|အရေးပါသော|adjective
察する|さっする|to guess, to sense, to presume, to judge|ခန့်မှန်းခြင်း|verb
さっと|さっと|quickly, suddenly|လျင်မြန်သည်|adverb
冊|さつ|counter for books|စာအုပ်အရေအတွက်|noun
殺人|さつじん|murder|အသက်သတ်ခြင်း|noun
偖|さて|well, now, then|သို့အတူ|adverb
悟る|さとる|to attain enlightenment, to perceive, to understand|နားလည်ခြင်း|verb
真実|さな|truth, reality|အမှန်တကယ်|noun
裁く|さばく|to judge|စွဲချခြင်း|verb
錆び|さび|rust (colour)|သံချေးမှု|noun
左程|さほど|not very, not much|အလွန်အကျွံမဟုတ်သည်|adverb
様|さま|Mr. or Mrs., manner, kind, appearance|အယ်ဒိုက်|noun
三味線|さみせん|three-stringed Japanese guitar, shamisen|တူးတူးသုံးခြင်း|noun
侍|さむらい|Samurai, warrior|သီးခွဲသည်|noun
然も|さも|with gusto, with satisfaction|အံ့ဆိုးသည်|adverb
作用|さよう|action, operation, effect, function|ရလဒ်|noun
左様なら|さようなら|good-bye|အလဲအပြောင်း|noun
拐う|さらう|to carry off, to run away with, to kidnap|နှုတ်ယူခြင်း|verb
爽やか|さわやか|fresh, refreshing, invigorating|အအေးအဆိုးမဲ့|adjective
障る|さわる|to hinder, to interfere with, to affect|အနံ့အဆေးခြင်း|verb
酸|さん|acid|အက်ဆစ်|noun
さん|さん|Mr or Mrs|အဲဒီ|noun
酸化|さんか|oxidation|အက်ဆစ်ဖြစ်သည်|noun
山岳|さんがく|mountains|ကုန်းတက်ကြီးကြီး|noun
産休|さんきゅう|maternity leave|အဝ်အင်|noun
桟橋|さんきょう|wharf, bridge, jetty, pier|တံတားခြင်း|noun
参議院|さんぎいん|House of Councillors|ကောင်စီအဖွဲ့|noun
産後|さんご|postpartum, after childbirth|မီးဖွယ်အခါ|noun
産出|さんしゅつ|yield, produce|ထွက်ပေါ်ခြင်း|noun
参照|さんしょう|reference, consultation|ကိုးကားခြင်း|noun
参上|さんじょう|calling on, visiting|လည်ပတ်သည်ခြင်း|noun
賛成|さんせい|approval, agreement, support|သဘောတူညီခြင်း|noun
賛美|さんび|praise, adoration, glorification|တုံးဝခြင်း|noun
産婦人科|さんふじんか|maternity and gynecology department|အမေတစ်မိုးအဖွဲ့|noun
産物|さんぶつ|product, result, fruit|အထွက်အထုတ်|noun
山腹|さんぷく|hillside, mountainside|ကုန်းပါး|noun
山脈|さんみゃく|mountain range|ကုန်းတန်းအလျား|noun
財|ざい|fortune, riches|စည်သည်|noun
財源|ざいげん|source of funds, resources, finances|ငွေကြေး|noun
在庫|ざいこ|stockpile, stock|သုံးစွဲထားခြင်း|noun
財政|ざいせい|economy, financial affairs|ငွေကြေး|noun
座談会|ざだんかい|symposium, round-table discussion|အစည်းအဝေး|noun
雑貨|ざっか|miscellaneous goods, general goods|အများအပြား|noun
雑|ざつ|rough, crude|အလုံးအစုံ|adjective
雑談|ざつだん|chatting, idle talk|အကြားအကွင်း|noun
雑木|ざつぼく|various kinds of small trees, assorted trees|သစ်ပင်အများ|noun
座標|ざひょう|coordinate(s)|တည်နေရာ|noun
残金|ざんきん|remaining money|ကျန်သည့်ငွေ|noun
残酷|ざんこく|cruelty, harshness|ကြမ်းတမ်းမှု|noun
残高|ざんだか|bank balance, remainder|ကျန်ပိုင်ဆိုင်ခြင်း|noun
死|し|death, decease|သေခြင်း|noun
し|し|10^24, septillion|ကုန်းခြင်း|noun
次|し|order, sequence, times, next|အလိုက်တစ်ခြင်း|noun
仕上がり|しあがり|finish, end, completion|အကိုးအကွယ်|noun
仕上げ|しあげ|end, finishing touches, being finished|အကိုးအကွယ်|noun
仕上げる|しあげる|to finish up, to complete|ပြီးဆုံးခြင်း|verb
明々後日|しあさって|two days after tomorrow|သုံးနေ့အနောက်|noun
飼育|しいく|breeding, raising, rearing|အမွေအမြတ်သည်|noun
強いて|しいて|by force|အတင်းအကျပ်|adverb
強いる|しいる|to force, to compel, to coerce|အတင်းအကျပ်ရ|verb
仕入れる|しいれる|to lay in stock, to replenish stock|ပြင်ဆင်ခြင်း|verb
しいんと|しいんと|silent, quiet|တိတ်တဆိတ်သည်|adverb
歯科|しか|dentistry|သွားထုံ|noun
資格|しかく|qualifications, requirements, capabilities|အထည်အမြင့်|noun
視覚|しかく|sense of sight, vision|အမြင်အာရုံ|noun
仕掛け|しかけ|device, trick, mechanism, gadget|အကုသလှည့်|noun
仕掛ける|しかける|to commence, to lay, to set, to wage, to challenge|စတင်ခြင်း|verb
然し|しかし|however, but|သို့သော်|adverb
然しながら|しかしながら|nevertheless, however|သို့သော်လည်း|adverb
而も|しかも|moreover, furthermore, nevertheless|အထင်အထန်|adverb
市街|しがい|urban areas, the streets, town|မြို့ဆန်းအတြင်း|noun
指揮|しき|command, direction|အညွှန်းအစီကမ်း|noun
色彩|しきさい|colour, hue, tints|အရောင်အသည်း|noun
式場|しきじょう|ceremonial hall, place of ceremony|အခမ်းအနားခန်း|noun
為来り|しきたり|customs|ထုံးစံ|noun
頻りに|しきりに|frequently, repeatedly, incessantly|အားတိုက်အားကြီးခြင်း|adverb
仕切る|しきる|to partition, to divide, to mark off, to settle|ခွဲခြားခြင်း|verb
資金|しきん|funds, capital|ငွေသည်|noun
しくじる|しくじる|to fail, to fall through, to blunder|မအောင်မြင်ခြင်း|verb
仕組み|しくみ|devising, plan, plot, contrivance|အစီအစဉ်|noun
死刑|しけい|death penalty, capital punishment|သေဒဏ်|noun
湿気る|しける|to be damp, to be moist|စိုစွတ်ခြင်း|verb
思考|しこう|thought|စိတ်တည်းဝယ်ခြင်း|noun
志向|しこう|intention, aim|ရည်ညွှန်းခြင်း|noun
嗜好|しこう|taste, liking, preference|နှစ်ခြင်းစိတ်ခြင်း|noun
視察|しさつ|inspection, observation|စူးစမ်းရှာဖွေခြင်း|noun
資産|しさん|property, fortune, means, assets|ပိုင်ဆိုင်ခြင်း|noun
刺繍|ししゅう|embroidery|ချည်ဆွဲခြင်း|noun
支持|しじ|support, maintenance|ကူညီခြင်း|noun
指示|しじ|indication, instruction, directions|အညွှန်းအစီကမ်း|noun
雫|しずく|drop (of water)|အစွန်တစ်စွန်း|noun
沈める|しずめる|to sink, to submerge|နစ်မြုပ်ခြင်း|verb
施設|しせつ|institution, establishment, facility|အဆောက်အအုံ|noun
子息|しそく|son|ကျား|noun
慕う|したう|to yearn for, to miss, to adore, to love|စိတ်မျှော်လင့်ခြင်း|verb
従って|したがって|therefore, consequently|ယင်းကြောင့်|adverb
下心|したごころ|secret intention, motive|လုံးဝစိတ်ခြင်း|noun
親しむ|したしむ|to be intimate with, to befriend|မိတ်ဆက်ခြင်း|verb
下調べ|したしらべ|preliminary investigation, preparation|အခြေခြင်းသုံးစွဲခြင်း|noun
下地|したじ|groundwork, foundation, inclination|အခြေခြင်း|noun
認める|したためる|to write up|အသိအလျှောက်ခြင်း|verb
仕立てる|したてる|to tailor, to make, to prepare, to train|ပြင်ဆင်ခြင်း|verb
下取り|したどり|trade in, part exchange|ကုန်သွယ်ခြင်း|noun
下火|したび|burning low, waning, declining|အားကျခြင်း|noun
失格|しっかく|disqualification, elimination|ရုံးခွင့်မပြုခြင်း|noun
確り|しっかり|firmly, tightly, reliable, level-headed|ခိုင်လုံသည်|adverb
質素|しっそ|simplicity, modesty, frugality|သိုဆည်းခြင်း|adjective
失調|しっちょう|lack of harmony|မသဲသည်ခြင်း|noun
嫉妬|しっと|jealousy|ဆန္ဒတူခြင်း|noun
尻尾|しっぽ|tail (animal)|အမြီ|noun
室|しつ|room|အခန်း|noun
質疑|しつぎ|question|မေးခွန်းတင်ခြင်း|noun
躾|しつけ|home discipline, training, upbringing|သင်ခန်းစာခြင်း|noun
仕付ける|しつける|to be used to a job, to begin to do, to baste|အလေ့အစေခြင်း|verb
指摘|してき|pointing out, identification|ထုတ်ဖော်ခြင်း|noun
視点|してん|opinion, point of view, visual point|အမြင်အကျင်း|noun
萎びる|しなびる|to wilt, to fade|သုံးမွန်းခြင်း|verb
嫋か|しなやか|supple, flexible, elastic|လွယ်ကူခြင်း|adjective
屎尿|しにょう|excreta, raw sewage, human waste|အညစ်အကြေး|noun
凌ぐ|しのぐ|to outdo, to surpass, to endure, to keep out|ကျော်လွှားခြင်း|verb
始発|しはつ|first train|ပထမဆုံးရထား|noun
芝|しば|lawn, sod, turf|အင်္ဂါ|noun
屡|しばしば|often, again and again, frequently|အားတိုက်မြည်းခြင်း|adverb
暫く|しばらく|little while|အချိန်သည်|noun
痺れる|しびれる|to become numb, to go to sleep|ခြင်းခြင်းခြင်း|verb
渋い|しぶい|tasteful, cool, astringent, sullen|အကွဲအခြင်း|adjective
私物|しぶつ|private property, personal effects|ကိုယ်ပိုင်အရာ|noun
しぶとい|しぶとい|tenacious, stubborn|အားထုတ်ခြင်း|adjective
司法|しほう|administration of justice|တရားဥပဒေ|noun
脂肪|しぼう|fat, grease, blubber|အဆီအကြေး|noun
志望|しぼう|wish, desire, ambition|မျှော်လင့်ခြင်း|noun
萎む|しぼむ|to wither, to fade away|သုံးမွန်းခြင်း|verb
仕舞|しまい|end, termination, informal (Noh play)|အဆုံး|noun
仕舞う|しまう|to finish, to close, to do completely|ပြီးဆုံးခြင်း|verb
しまった|しまった|Damn it!|အလုံးအစုံ|adverb
始末|しまつ|management, dealing, settlement|စီမံခန်း|noun
泌み泌み|しみじみ|keenly, deeply, heartily|အကြေးအကြေးခြင်း|adverb
染みる|しみる|to pierce, to permeate|စိုက်ခြင်း|verb
使命|しめい|mission, errand, message|တာဝန်|noun
締め切り|しめきり|closing, cut-off, end, deadline|သတ်မှတ်တည်းဝယ်ခြင်း|noun
僕|しもべ|manservant, servant of God|ကျေးဇူးခြင်း|noun
社交|しゃこう|social life, social intercourse|အကျင်းအကွင်း|noun
謝絶|しゃぜつ|refusal|ငြင်းပယ်ခြင်း|noun
社宅|しゃたく|company owned house|ကုမ္ပဏီအိမ်|noun
吃逆|しゃっくり|hiccough, hiccup|အအီးအဆိုခြင်း|noun
喋る|しゃべる|to talk, to chat, to chatter|စကားပြောခြင်း|verb
斜面|しゃめん|slope, slanting surface, bevel|အစောင်းအစောင်း|noun
洒落|しゃらく|frank, open-hearted|အရွယ်အစားခြင်း|noun
洒落る|しゃれる|to joke, to play on words, to dress stylishly|အဆိုးအကုန်ခြင်း|verb
視野|しや|field of vision, outlook|အမြင်အတိုင်း|noun
種|しゅ|kind, variety, species|အမျိုးအစား|noun
衆|しゅう|masses, great number, the people|အများအပြား|noun
周|しゅう|circuit, lap, circumference, vicinity|အနီးအနား|noun
収益|しゅうえき|earnings, proceeds, returns|အရေအတွက်|noun
修学|しゅうがく|learning|သင်ခန်းစာခြင်း|noun
周期|しゅうき|cycle, period|အကြိမ်အခါ|noun
衆議院|しゅうぎいん|Lower House, House of Representatives|ကောင်စီအဖွဲ့|noun
就業|しゅうぎょう|employment, starting work|အလုပ်|noun
修行|しゅうぎょう|pursuit of knowledge, studying, training|သင်ခန်းစာခြင်း|noun
集計|しゅうけい|totalization, aggregate|စုစည်းခြင်း|noun
襲撃|しゅうげき|attack, charge, raid|ကျော်လွှားခြင်း|noun
収支|しゅうし|income and expenditure|အငွေများ|noun
終始|しゅうし|beginning and end, from beginning to end|အစမ်းအဆုံး|noun
修士|しゅうし|Masters degree program|ပညာရည်|noun
収集|しゅうしゅう|gathering up, collection, accumulation|စုဆောင်းခြင်း|noun
修飾|しゅうしょく|ornamentation, embellishment, decoration|အလှအဆင်|noun
終日|しゅうじつ|all day|တစ်နေ့လုံး|noun
執着|しゅうじゃく|attachment, adhesion, tenacity|အလွတ်အမုန်း|noun
収容|しゅうよう|accommodation, reception, seating, housing|သုံးစွဲခြင်း|noun
修了|しゅうりょう|completion of a course|အပြီးအစီးခြင်း|noun
守衛|しゅえい|security guard, doorkeeper|စောင့်ကြည့်သည်|noun
主演|しゅえん|starring, playing the leading part|အဓိကဟာသ|noun
主観|しゅかん|subjectivity, subject, ego|ကိုယ်တိုင်အမြင်|noun
祝賀|しゅくが|celebration, congratulations|ဆုံးမတင်ခြင်း|noun
宿命|しゅくめい|fate, destiny, predestination|ကံကည|noun
主権|しゅけん|sovereignty, supremacy, dominion|အခွင့်အရေး|noun
手芸|しゅげい|handicrafts|ကျွမ်းကျင်ခြင်း|noun
主催|しゅさい|organization, sponsorship|စီမံခန်း|noun
取材|しゅざい|choice of subject, collecting data|စုဆောင်းခြင်း|noun
趣旨|しゅし|object, meaning|အဆိုအဆို|noun
主食|しゅしょく|staple food|အဓိကအစားအရitis|noun
主人公|しゅじんこう|protagonist, main character, hero(ine)|အဓိကဇာတ်ကောင်|noun
主体|しゅたい|subject, main constituent|အဓိကအပုဒ်|noun
主題|しゅだい|subject, theme, motif|အဆိုအဆို|noun
出血|しゅっけつ|bleeding, haemorrhage|သွေးထွက်ခြင်း|noun
出産|しゅっさん|birth, delivery, production of goods|ကလေးမွေးခြင်း|noun
出社|しゅっしゃ|arrival at work|အလုပ်ခြင်း|noun
出生|しゅっしょう|birth|မွေးဖွားခြင်း|noun
出世|しゅっせ|promotion, successful career, eminence|အဆင့်တက်ခြင်း|noun
出費|しゅっぴ|expenses, disbursements|အငွေများ|noun
出品|しゅっぴん|exhibit, display|တင်ခွင့်ပြုခြင်း|noun
出演|しゅつえん|performance, stage appearance|ပွဲ ထွက်ခြင်း|noun
出題|しゅつだい|proposing a question|မေးခွန်းတင်ခြင်း|noun
出動|しゅつどう|sailing, marching, going out|ထွက်ခွာခြင်း|noun
主導|しゅどう|main leadership|အဓိကအညွှန်း|noun
主任|しゅにん|person in charge, responsible official|အဓိကတာဝန်|noun
首脳|しゅのう|head, brains|အဆင့်မြင့်သည်|noun
守備|しゅび|defense|ကာကွယ်ခြင်း|noun
手法|しゅほう|technique|နည်းစနစ်|noun
私有|しゆう|private ownership|ကိုယ်ပိုင်ခြင်း|noun
諸|しょ|various, many, several|အမျိုးမျိုး|adverb
背負う|しょう|to be burdened with, to carry on back or shoulder|ထမ်းဆောင်ခြင်း|verb
象|しょう|phenomenon|အပြင်အထွေ|noun
症|しょう|illness|ရောဂါ|noun
傷|しょう|wound, injury, hurt, cut|ဒဏ်ခံခြင်း|noun
商|しょう|quotient|လုံးလစ်ခြင်း|noun
消去|しょうきょ|elimination, erasing, dying out|ဖျက်ဆီးခြင်း|noun
衝撃|しょうげき|shock, crash, impact|တုန်လှုပ်ခြင်း|noun
証言|しょうげん|evidence, testimony|အသိအလျှောက်ခြင်း|noun
証拠|しょうこ|evidence, proof|အသက်သေခြင်း|noun
消耗|しょうこう|exhaustion, consumption|သုံးဆုံးခြင်း|noun
照合|しょうごう|collation, comparison|နှိုင်းယှဉ်ခြင်း|noun
詳細|しょうさい|detail, particulars|အသေးအဆင်း|noun
昇進|しょうしん|promotion|အဆင့်တက်ခြင်း|noun
少数|しょうすう|minority, few|အနည်းစုံ|noun
称する|しょうする|to pretend, to take the name of, to feign|အမည်အရည်အသည်း|verb
消息|しょうそく|news, letter, circumstances|သတင်း|noun
承諾|しょうだく|consent, acquiescence, agreement|သဘောတူညီခြင်း|noun
象徴|しょうちょう|symbol|လက်ခြင်း|noun
小児科|しょうにか|pediatrics|ကလေးဆေးခန်း|noun
証人|しょうにん|witness|သက်သေ|noun
照明|しょうめい|illumination|အလင်းခြင်း|noun
勝利|しょうり|victory, triumph, conquest, success|အနိုင်အရဲ|noun
奨励|しょうれい|encouragement, promotion, message|စိတ်ဓာတ်|noun
職員|しょくいん|staff member, personnel|ရုံးအလုပ်သည်|noun
植民地|しょくみんち|colony|သိမ်းပိုက်ခြင်း|noun
職務|しょくむ|professional duties|အလုပ်တာဝန်|noun
諸君|しょくん|Gentlemen, Ladies|လူမှုအဖွဲ့|noun
所在|しょざい|whereabouts|တည်နေရာ|noun
所々|しょしょ|here and there, some parts|အခြင်းအခြင်း|noun
所持|しょじ|possession, owning|ပိုင်ဆိုင်ခြင်း|noun
所属|しょぞく|attached to, belong to|သူမှီခြင်း|noun
処置|しょち|treatment|ကုသခြင်း|noun
しょっちゅう|しょっちゅう|always, constantly|အစဉ်အမြဲ|adverb
所定|しょてい|fixed, prescribed|သတ်မှတ်ခြင်း|adjective
所得|しょとく|income, earnings|အလုံးအစုံ|noun
初版|しょはん|first edition|ပထမ ထုတ်ဝေမှု|noun
処罰|しょばつ|punishment|ဒဏ်ခတ်ချက်|noun
書評|しょひょう|book review|စာအုပ်အကျင်းအကွင်း|noun
処分|しょぶん|disposal, dealing, punishment|စီမံခန်း|noun
庶民|しょみん|masses, common people|အများကျေးဇူး|noun
庶務|しょむ|general affairs|အများပွဲစီစဉ်ချက်|noun
私用|しよう|personal use, private business|ကိုယ်ပိုင်အသုံးပြုခြင်း|noun
仕様|しよう|way, method, resource, remedy|အရည်အသည်း|noun
使用人|しようにん|employee, servant|အလုပ်သည်|noun
調べ|しらべ|preparation, investigation, inspection|စူးစမ်းခြင်း|noun
知り合い|しりあい|acquaintance|အမိတ်ဆက်|noun
退く|しりぞく|to retreat, to recede, to withdraw|ကျဆုံးခြင်း|verb
退ける|しりぞける|to repel, to drive away|နှုတ်ယူခြင်း|verb
記す|しるす|to note, to write down|စာသားခြင်း|verb
指令|しれい|orders, instructions, directive|အညွှန်းအစီကမ်း|noun
代|しろ|price, materials, substitution|အစားထိုးခြင်း|noun
皺|しわ|wrinkles, creases|အကွေးအခြင်း|noun
新|しん|new|အသစ်|adjective
進化|しんか|evolution, progress|တွင်းတွင်းပွင့်ပွင့်|noun
殿|しんがり|rear, rear unit guard|ေနာက်ခံ|noun
審議|しんぎ|deliberation|စဉ်းစားခြင်း|noun
進行|しんこう|advance|မျှော်လင့်ခြင်း|noun
新興|しんこう|rising, developing, emergent|အသစ်စတင်ခြင်း|adjective
振興|しんこう|promotion, encouragement|စိတ်ဓာတ်|noun
申告|しんこク|report, statement, filing a return|အကျင်းအကွင်း|noun
新婚|しんこん|newly-wed|လမ်းလမ်းပျော်ပျော်|adjective
審査|しんさ|judging, inspection, examination|စူးစမ်းခြင်း|noun
紳士|しんし|gentleman|မင်းသည်သတ္တုသ|noun
進出|しんしゅつ|advance, step forward|အရှေ့သို့ခြင်း|noun
信者|しんじゃ|believer, adherent, devotee|ယုံကြည်သူ|noun
真珠|しんじゅ|pearl|မုတ္တမုံ|noun
心中|しんじゅう|double suicide, lovers suicide|စိတ်တည်းဝယ်အမုန်း|noun
心情|しんじょう|mentality|စိတ်မှတ်သားချက်|noun
新人|しんじん|new face, newcomer|အသစ်ကောင်|noun
神聖|しんせい|holiness, sacredness, dignity|သန်းတင်ခြင်း|adjective
親善|しんぜん|friendship|မိတ်ဆက်ခြင်း|noun
真相|しんそう|truth, real situation|အမှန်တကယ်|noun
新築|しんちく|new building, new construction|အသစ်သည့်အိမ်|noun
進呈|しんてい|presentation|တင်ခွင့်ပြုခြင်း|noun
進展|しんてん|progress, development|တွင်းတွင်းပွင့်ပွင့်|noun
神殿|しんでん|temple, sacred place|စေတီ|noun
進度|しんど|progress|မျှော်လင့်ခြင်း|noun
振動|しんどう|oscillation, vibration|တုန်လှုပ်ခြင်း|noun
新入生|しんにゅうせい|freshman, first-year student|အနစ်နပ်ကျောင်းသူ|noun
信任|しんにん|trust, confidence, credence|ယုံကြည်ခြင်း|noun
審判|しんばん|refereeing, trial, judgement, umpire|စဉ်းစားခြင်း|noun
神秘|しんぴ|mystery|သျှူးမုံမုံ|noun
辛抱|しんぼう|patience, endurance|သည့်တည်းခြင်း|noun
真理|しんり|truth|အမှန်တကယ်|noun
侵略|しんりゃく|aggression, invasion, raid|ကျော်လွှားခြင်း|noun
診療|しんりょう|medical examination and treatment|ကုသခြင်း|noun
進路|しんろ|course, route|လမ်းကြောင်း|noun
自覚|じかく|self-conscious|ကိုယ်သိခြင်း|noun
地方|じかた|area, locality, district, region|ဒေသ|noun
自我|じが|self, the ego|ကိုယ်အသိအမြင်|noun
磁気|じき|magnetism|သံလိုက်ခြင်း|noun
磁器|じき|porcelain, china|ကွန်ယက်|noun
事業|じぎょう|project, enterprise, business|လုပ်ငန်း|noun
地形|じぎょう|terrain, geographical features|မြေပြင်|noun
軸|じく|axis, stem, shaft, axle|တဖက်|noun
自己|じこ|self, oneself|ကိုယ်တိုင်|noun
事項|じこう|matter, item, facts|အကိစ္စအရာ|noun
時刻表|じこくひょう|table, diagram, chart, timetable|အချိန်အဆင့်|noun
地獄|じごく|hell|အကောင့်အကွေး|noun
時差|じさ|time difference|အချိန်ကွာခြင်း|noun
自在|じざい|freely, at will|လွယ်ကူခြင်း|adverb
自主|じしゅ|independence, autonomy|ကိုယ်တိုင်သည်|noun
自首|じしゅ|surrender, give oneself up|အမုန်းခြင်း|noun
辞職|じしょく|resignation|အလုပ်ထွက်ခြင်း|noun
自信|じしん|self-confidence|ကိုယ်တိုင်ယုံကြည်ခြင်း|noun
事前|じぜん|prior, beforehand, in advance|အကြိုတွင်|noun
自尊心|じそんしん|self-respect, conceit|မြင့်မြတ်သည်|noun
持続|じぞく|continuation|ဆက်လက်ခြင်း|noun
字体|じたい|type, font, lettering|အက္ခရာပုံစံ|noun
辞退|じたい|refusal|ငြင်းပယ်ခြင်း|noun
じっくり|じっくり|deliberately, carefully|သည့်သည့်တည်းတည်း|adverb
実質|じっしつ|substance, essence|အခြေခြင်း|noun
実践|じっせん|practice, put into practice|လုပ်အားထုတ်ခြင်း|noun
実態|じったい|truth, fact|အမှန်တကယ်အခြေအနေ|noun
実費|じっぴ|actual expense, cost price|အဖိုးအခကြေး|noun
十分|じっぷん|10 minutes|တစ်မိနစ်|noun
実|じつ|truth, reality, sincerity, fidelity|အမှန်တကယ်|noun
実業家|じつぎょうか|industrialist, businessman|လုပ်ငန်းရှင်|noun
実情|じつじょう|real condition, actual circumstances|အမှန်အခြေအနေ|noun
自転|じてん|rotation, spin|လှည့်ကောက်ခြင်း|noun
自動詞|じどうし|intransitive verb|သတ္တုဆီးအရုပ်|noun
地主|じぬし|landlord|မြေယာပိုင်|noun
耳鼻科|じびか|otolaryngology|နှာခေါင်းဆေးခန်း|noun
地元|じもと|local|ဒေသခံ|adjective
弱|じゃく|weakness, the weak|အားနည်း|noun
若干|じゃっかน|some, few, number of|အနည်းအခြင်း|noun
砂利|じゃり|gravel, ballast, pebbles|ကျောက်တုံး|noun
じゃん拳|じゃんけん|rock-scissors-paper game|လက်ခြင်းဂိမ်း|noun
住|じゅう|dwelling, living|နေထိုင်ခြင်း|noun
従業員|じゅうぎょういん|employee, worker|အလုပ်သည်|noun
従事|じゅうじ|engaging, pursuing, following|လုပ်ဆောင်ခြင်း|verb
充実|じゅうじつ|fullness, completion, perfection|ပြည့်ဝခြင်း|noun
十字路|じゅうじろ|crossroads|လမ်းကွန်းခြင်း|noun
絨毯|じゅうたん|carpet|အခြင်းအခြင်း|noun
柔軟|じゅうなん|flexible, lithe|လွယ်ကူခြင်း|adjective
重複|じゅうふく|duplication, repetition, overlapping|ထပ်နေခြင်း|noun
重宝|じゅうほう|priceless treasure, convenience|အဆင်အလိုတစ်ခြင်း|noun
従来|じゅうらい|up to now, so far, traditional|အကြေးအကြေး|noun
塾|じゅく|coaching school, lessons|သင်ခန်းစာခြင်း|noun
樹木|じゅもく|trees and shrubs|သစ်ပင်အုပ်စုံ|noun
樹立|じゅりつ|establish, create|စည်းမုံရ|verb
準急|じゅんきゅう|local express (train)|အလယ်အလတ်ရထား|noun
準じる|じゅんじる|to follow, to conform, to apply to|လိုက်လျောက်ခြင်း|verb
準ずる|じゅんずる|to apply correspondingly, to correspond to|လိုက်လျောက်ခြင်း|verb
助|じょ|help, rescue, assistant|ကူညီခြင်း|noun
情|じょう|feelings, emotion, passion|စိတ်အုပ်စုံ|noun
畳|じょう|mat, a unit of area|အခြင်းအခြင်း|noun
尉|じょう|jailer, old man, rank|ရဲအုပ်|noun
嬢|じょう|young woman|အမျိုးသမီး|noun
状|じょう|shape|ပုံသဏ္ဍာန်|noun
上位|じょうい|superior, higher order|အဆင့်မြင့်သည်|noun
上演|じょうえん|performance|ပွဲအဆင့်|noun
城下|じょうか|land near the castle|ရုံးထဲ|noun
乗客|じょうかく|passenger|ခရီးသည်|noun
上空|じょうくう|sky, the skies|လေကြည|noun
上司|じょうし|superior authorities, boss|ရုံးအုပ်ချုပ်|noun
情緒|じょうしょ|emotion, feeling|စိတ်အုပ်စုံ|noun
上昇|じょうしょう|rising, ascending, climbing|တက်ခြင်း|noun
情勢|じょうせい|state of things, condition|အခြေအနေ|noun
情熱|じょうねつ|passion, enthusiasm, zeal|စိတ်အားထုတ်ခြင်း|noun
丈夫|じょうふ|hero, gentleman, warrior|ခိုင်လုံသည်|adjective
譲歩|じょうほ|concession, conciliation|သဘောတူညီခြင်း|noun
条約|じょうやく|treaty, pact|သဘောတူညီချက်|noun
上陸|じょうりく|landing, disembarkation|ကုန်းသို့ကျခြင်း|noun
蒸留|じょうりゅう|distillation|ည}ည}ခြင်း|noun
除外|じょがい|exception, exclusion|ခြင်းခြင်း|noun
助言|じょげん|advice, suggestion|အကြံအစည်|noun
徐行|じょこう|going slowly|နှေးခြင်း|adverb
女史|じょし|Ms.|အမျိုးသမီး|noun
助詞|じょし|particle, postposition|သုံးအကုံးအကျွယ်|noun
助動詞|じょどうし|auxiliary verb|အမူအရာတည်းဝယ်|noun
自立|じりつ|independence, self-reliance|ကိုယ်တိုင်သည်|noun
人|じん|man, person, people|လူ|noun
人格|じんかく|personality, character, individuality|ကိုယ်သိခြင်း|noun
人材|じんざい|man of talent|လူမြင့်|noun
迅速|じんそく|quick, fast, rapid, swift, prompt|လျင်မြန်သည်|adjective
人体|じんたい|human body|လူကိုယ်အခန်း|noun
人民|じんみん|people, public|လူများ|noun
人目|じんもく|glimpse, public gaze|လူမြင်ခြင်း|noun
水気|すいき|moisture, dampness, vapor|စိုစွတ်မှု|noun
水源|すいげん|source of river, fountainhead|ရေအခြင်း|noun
推進|すいしん|propulsion, driving force|ကြိုတင်စွန့်ခွာခြင်း|noun
水洗|すいせん|flushing|ရေဆေးခြင်း|noun
吹奏|すいそう|playing wind instruments|တူရိယာမှုတ်ခြင်း|noun
推測|すいそく|guess, conjecture|ခန့်မှန်းခြင်း|noun
水田|すいでん|paddy field|စိုက်ခင်း|noun
推理|すいり|reasoning, inference, mystery|တြန်းခြင်း|noun
数詞|すうし|numeral|ကိန်းဂဏန်း|noun
崇拝|すうはい|worship, adoration, admiration|ကျောက်တုံးကျောက်တုံး|noun
据え付ける|すえつける|to install, to equip, to mount|တည်ဆောက်ခြင်း|verb
据える|すえる|to set, to lay, to place, to apply|တည်ခိုင်းခြင်း|verb
清々しい|すがすがしい|fresh, refreshing|ကြည်လင်သည်|adjective
過ぎ|すぎ|past, after|ကြွးကျန်ခြင်း|noun
救い|すくい|help, aid, relief|ကူညီခြင်း|noun
掬う|すくう|to scoop, to ladle out|လုံးဝစုစည်းခြင်း|verb
少なくとも|すくなくとも|at least|အနည်းဆုံး|adverb
直ぐ|すぐ|immediately, soon, easily|ချက်ချင်း|adverb
健やか|すこやか|vigorous, healthy, sound|ကျန်းမာသည်|adjective
濯ぐ|すすぐ|to rinse, to wash out|ရေဆေးခြင်း|verb
進み|すすみ|progress|မျှော်လင့်ခြင်း|noun
勧め|すすめ|recommendation, advice, encouragement|အကြံအစည်|noun
裾|すそ|trouser cuff, skirt hem|အခြင်းအခြင်း|noun
廃れる|すたれる|to go out of use, to become obsolete|အသုံးမခံခြင်း|verb
酸っぱい|すっぱい|sour, acid|အက်ဆစ်သည်|adjective
素敵|すてき|lovely, dreamy, beautiful, great|လှပသည်|adjective
即ち|すなわち|that is, namely|အဆိုပါ|adverb
すばしこい|すばしこい|nimble, smart, quick|လျင်မြန်သည်|adjective
素早い|すばやい|fast, quick, prompt, agile|လျင်မြန်သည်|adjective
済ます|すます|to finish, to get it over with, to settle|ပြီးဆုံးခြင်း|verb
澄ます|すます|to clear, to make clear, to be unruffled|သန်ရေဆေးခြင်း|verb
済まない|すまない|sorry|တောင်းပန်ခြင်း|adjective
済みません|すみません|sorry, excuse me|တောင်းပန်ခြင်း|noun
天皇|すめらぎ|Emperor of Japan|တရားဥပဒေ|noun
刷り|すり|printing|ပုံနှိပ်ခြင်း|noun
剃る|する|to shave|ခေါင်းဆိတ်ခြင်း|verb
擦れ違い|すれちがい|chance encounter|မီးတောင်းခြင်း|noun
すれ違う|すれちがう|to pass by one another, to disagree|ကွဲပြားခြင်း|verb
擦れる|すれる|to rub, to chafe, to wear|အဝတ်အတွင်းခြင်း|verb
すんなり|すんなり|pass with no objection, slim, slender|စည်းမုံခြင်း|adverb
図々しい|ずうずうしい|impudent, shameless|သူမုံမုံခြင်း|adjective
ずばり|ずばり|decisively, decidedly|အတင်းအကျပ်|adverb
ずぶ濡れ|ずぶぬれ|soaked, dripping wet|စုံတွေးတွေးခြင်း|adjective
ずらっと|ずらっと|in a line, in a row|တစ်စုံတည်းခြင်း|adverb
ずるずる|ずるずる|sound of dragging, loose, inconclusive|ခြင်းခြင်းခြင်း|noun
ずれ|ずれ|gap, slippage|အကွာအဝေး|noun
ずれる|ずれる|to slide, to slip off|ဆင်းရဲခြင်း|verb
制|せい|system, organization, regulation|စည်းမုံခြင်း|noun
製|せい|made|ပြုလုပ်ခြင်း|suffix
生育|せいいく|growth, development, breeding|ကြီးထွားခြင်း|noun
成果|せいか|results, fruits|ရလဒ်|noun
正解|せいかい|correct, right, correct interpretation|အမှန်အဖြေ|noun
正規|せいき|regular, legal, formal, established|ခွင့်ပြုခြင်း|adjective
正義|せいぎ|justice, right, righteousness|တရားမျှတခြင်း|noun
生計|せいけい|livelihood, living|အသက်ကျေးဇူး|noun
政権|せいけん|administration, political power|အုပ်ချုပ်ခြင်း|noun
精巧|せいこう|elaborate, delicate, exquisite|နူပညာခြင်း|adjective
制裁|せいさい|restraint, sanctions, punishment|ဒဏ်ခတ်ချက်|noun
政策|せいさく|political measures, policy|အစီအစဉ်|noun
清算|せいさん|liquidation, settlement|အငွေချေမှု|noun
星座|せいざ|constellation|별ထူးခွ|noun
生死|せいし|life and death|အသက်သေခြင်း|noun
静止|せいし|stillness, repose, standing still|တည်နေခြင်း|noun
青春|せいしゅん|youth, springtime of life|လူငယ်ခေတ်|noun
聖書|せいしょ|Bible, scriptures|သမ္မာကျမ်းစာ|noun
誠実|せいじつ|sincere, honest, faithful|သစ္စာခြင်း|adjective
成熟|せいじゅく|maturity, ripeness|သည့်တည်းခြင်း|noun
清純|せいじゅん|purity, innocence|သန်ရေခြင်း|noun
正常|せいじょう|normalcy, normality, normal|သဘာဝပုံစံ|adjective
制する|せいする|to control, to command, to get the better of|အုပ်ချုပ်ခြင်း|verb
整然|せいぜん|orderly, regular, well-organized|စည်းကမ်းသည်|adjective
盛装|せいそう|be dressed up, wear rich clothes|အလှတစ်သည့်ခြင်း|noun
盛大|せいだい|grand, prosperous, magnificent|လူများခြင်း|adjective
清濁|せいだく|good and evil, purity and impurity|ကောင်းမွန်သည်|noun
制定|せいてい|enactment, establishment, creation|သတ်မှတ်ခြင်း|noun
静的|せいてき|static|တည်နေခြင်း|adjective
製鉄|せいてつ|iron manufacture|သံပြုလုပ်ခြင်း|noun
晴天|せいてん|fine weather|နေဖြူခြင်း|noun
正当|せいとう|just, justifiable, right|တရားမျှတခြင်း|adjective
成年|せいねん|majority, adult age|အရွယ်ရောက်ခြင်း|noun
制服|せいふく|uniform|အဝတ်အစည်း|noun
征服|せいふく|conquest, subjugation, overcoming|အုပ်စုံခြင်း|noun
製法|せいほう|manufacturing method, recipe|ပြုလုပ်ခြင်းနည်း|noun
精密|せいみつ|precise, exact, detailed, minute|အသေးအဆင်း|adjective
声明|せいめい|declaration, statement, proclamation|အဆိုအဆို|noun
姓名|せいめい|full name|အမည်အစုံ|noun
制約|せいやく|limitation, restriction, condition|ကန့်သတ်ခြင်း|noun
生理|せいり|physiology, menses|ကိုယ်ခန္ဓာခြင်း|noun
勢力|せいりょク|influence, power, might, strength|အားအလုံးအစုံ|noun
整列|せいれつ|stand in a row, form a line|စည်းကမ်းသည်|noun
急かす|せかす|to hurry, to urge on|လျင်မြန်စေခြင်း|verb
伜|せがれ|son, my son|ကျား|noun
責務|せきむ|duty, obligation|တာဝန်|noun
世辞|せじ|flattery, compliment|ကျေးဇူးပြောခြင်း|noun
世帯|せたい|household|အိမ်အနီးအနား|noun
世代|せだい|generation, the world, the age|လူမျိုးစုံ|noun
切開|せっかい|clearing, opening up, cutting through|အဖတ်ခြင်း|noun
接触|せっしょく|touch, contact|ထိခိုက်ခြင်း|noun
設置|せっち|establishment, institution|တည်ဆောက်ခြင်း|noun
折衷|せっちゅう|compromise, cross, blending|ကြားခြင်း|noun
設定|せってい|establishment, creation|သတ်မှတ်ခြင်း|noun
説得|せっとく|persuasion|ကျေးဇူးတင်ခြင်း|noun
節|せつ|node, section, occasion, time|အခါ|noun
切実|せつじつ|compelling, serious, severe, acute|အရေးအပါ|adjective
接続詞|せつぞくし|conjunction|စာသားချိုးခြင်း|noun
切ない|せつない|painful, trying, oppressive|စုံတွေးခြင်း|adjective
設立|せつりつ|establishment, foundation, institution|တည်ဆောက်ခြင်း|noun
攻め|せめ|attack, offence|ကျော်လွှားခြင်း|noun
世論|せろん|public opinion|လူများအမြင်|noun
仙|せん|hermit, wizard|တရားဆရာ|noun
前|せん|before|အရှေ့|adverb
繊維|せんい|fibre, fiber, textile|အချည်|noun
選挙|せんきょ|election|မဲမြ|noun
宣教|せんきょう|religious mission|ကျမ်းဆရာခြင်း|noun
宣言|せんげん|declaration, proclamation, announcement|အဆိုအဆို|noun
先行|せんこう|preceding, going first|အရှေ့ခြင်း|noun
選考|せんこう|selection, screening|ရွေးချယ်ခြင်း|noun
戦災|せんさい|war damage|စစ်ဆင်ခြင်းဒဏ်|noun
専修|せんしゅう|specialization|အထူးကျွမ်းခြင်း|noun
戦術|せんじゅつ|tactics|စစ်တန်းအစီအစဉ်|noun
潜水|せんすい|diving|နစ်မြုပ်ခြင်း|noun
先先月|せんせんげつ|month before last|ပြီးခဲ့သည့်လ|noun
先先週|せんせんしゅう|week before last|ပြီးခဲ့သည့်ပတ်|noun
先代|せんだい|family predecessor, previous age|အကြေးအကြေးခြင်း|noun
先だって|せんだって|recently, the other day|လွန်ခဲ့တဲ့နေ့|adverb
先着|せんちゃく|first arrival|ပထမဆုံးရောက်ခြင်း|noun
先天的|せんてんてき|a priori, inborn, innate|မွေးဖွားခြင်းမှ|adjective
戦闘|せんとう|battle, fight, combat|စစ်ရေး|noun
潜入|せんにゅう|infiltration, sneaking in|ရှိုးခြင်း|noun
船舶|せんぱク|ship|သင်္ဘော|noun
専用|せんよう|exclusive use, personal use|အထူးသုံးစွဲခြင်း|noun
占領|せんりょう|occupation, capture, possession|သိမ်းပိုက်ခြင်း|noun
戦力|せんりょく|war potential|စစ်အားထုတ်ခြင်း|noun
税務署|ぜいむしょ|tax office|အခွန်လုံ|noun
是正|ぜせい|correction, revision|ပြင်ဆင်ခြင်း|noun
絶版|ぜっぱん|out of print|ထုတ်ဝေမှုမပြုခြင်း|noun
絶望|ぜつぼう|despair, hopelessness|စိတ်ဓာတ်ကျခြင်း|noun
是非とも|ぜひとも|by all means|အလျှင်းအကျွံ|adverb
膳|ぜん|small table, tray, meal|စားပွဲ|noun
禅|ぜん|Zen (Buddhism)|စူဖီယံသာသနာ|noun
全快|ぜんかい|complete recovery of health|ကျန်းမာရပ်ခြင်း|noun
全盛|ぜんせい|height of prosperity|အမြင့်အသီးခြင်း|noun
前提|ぜんてい|preamble, premise, reason, prerequisite|အခြေခြင်း|noun
前途|ぜんと|future prospects, outlook|အနာဂတ်|noun
全滅|ぜんめつ|annihilation|လုံးဝဆုံးရှုံးခြင်း|noun
善良|ぜんりょう|goodness, excellence, virtue|ကောင်းမွန်သည်|adjective
前例|ぜんれい|precedent|ထုံးစံ|noun
僧|そう|monk, priest|သံဃာ|noun
沿う|そう|to run along, to follow|လိုက်လျောက်ခြင်း|verb
添う|そう|to accompany, to become married, to comply|အတူလိုက်ခြင်း|verb
総|そう|whole, all, general, gross|အလုံးအစုံ|adjective
相応|そうおう|suitability, fitness|သင့်တင့်သည်|noun
総会|そうかい|general meeting|အများအဖွဲ့အစည်း|noun
創刊|そうかん|launching, first issue|ပထမဆုံးထုတ်ဝေမှု|noun
送金|そうきん|remittance, sending money|ငွေလွှဲခြင်း|noun
走行|そうこう|running a wheeled vehicle|လျင်မြန်စွီးခြင်း|noun
総合|そうごう|synthesis, coordination, putting together|ပေါင်းစည်းခြင်း|noun
捜査|そうさ|search, investigation|စူးစမ်းခြင်း|noun
捜索|そうさく|search, investigation|စူးစမ်းခြင်း|noun
然うして|そうして|and, like that|ဒီလို|adverb
装飾|そうしょく|ornament|အလှအဆင်|noun
操縦|そうじゅう|management, handling, control|အုပ်ချုပ်ခြင်း|noun
創造|そうぞう|creation|ပြုလုပ်ခြင်း|noun
壮大|そうだい|magnificent, grand, majestic|ကြီးမားခြင်း|adjective
騒動|そうどう|strife, riot, rebellion|အရုံးအတုန်းခြင်း|noun
遭難|そうなん|disaster, shipwreck, accident|အ危ုံးအသည်းခြင်း|noun
相場|そうば|market price, speculation, estimation|ကုန်သည်ရေ|noun
装備|そうび|equipment|အသုံးအဆောင်|noun
創立|そうりつ|establishment, founding, organization|တည်ဆောက်ခြင်း|noun
添える|そえる|to add to, to attach, to append|ပေါင်းထည့်ခြင်း|verb
即座に|そくざに|immediately, right away|ချက်ချင်း|adverb
促進|そくしん|promotion, acceleration, encouragement|လျင်မြန်စေခြင်း|noun
即する|そくする|to conform to, to agree with|သဘောတူညီခြင်း|verb
束縛|そくばク|restraint, shackles, restriction|ကန့်သတ်ခြင်း|noun
側面|そくめん|side, flank, sidelight|အခြင်းအခြင်း|noun
其処|そこ|that place, there|ဒီနေရာ|noun
其処で|そこで|so, accordingly, now, then|ထိုကြောင့်|adverb
損なう|そこなう|to harm, to hurt, to injure, to damage|ဒဏ်ခံခြင်း|verb
其処ら|そこら|everywhere, somewhere, approximately|အနီးအနား|adverb
素材|そざい|raw materials, subject matter|အခြင်းအခြင်း|noun
阻止|そし|obstruction, check, hindrance|အခြင်းခြင်းခြင်း|noun
然して|そして|and|နှင့်|adverb
訴訟|そしょう|litigation, lawsuit|တရားရုံးအရုံး|noun
育ち|そだち|breeding, growth|ကြီးထွားခြင်း|noun
措置|そち|measure, step|အဆင့်အတန်း|noun
其方|そちら|over there, the other|ဒီအစိတ်|noun
素っ気ない|そっけない|cold, short, curt, blunt|ခွင့်မပြုခြင်း|adjective
率直|そっちょく|frankness, candour|စျေးတင်ခြင်း|noun
外方|そっぽ|look the other way|အခြင်းခြင်းခြင်း|noun
備え付ける|そなえつける|to provide, to furnish, to equip|ပြင်ဆင်ခြင်း|verb
備わる|そなわる|to be furnished with, to be endowed with|ရှိခြင်း|verb
園|その|garden, park, plantation|ဥယျာဉ်|noun
その上|そのうえ|in addition, furthermore|အပြင်အဆင့်|adverb
その内|そのうち|eventually, sooner or later|ကာလအတိုင်း|adverb
その為|そのため|hence, for that reason|ယင်းကြောင့်|adverb
その外|そのほか|besides, in addition, the rest|အခြားအရာ|adverb
其の儘|そのまま|without change, as it is|ဟုတ်သည်အတိုင်း|adverb
聳える|そびえる|to rise, to tower, to soar|တည်ဆောက်ခြင်း|verb
素朴|そぼク|simplicity, artlessness, naivete|ရိုးသားသည်|adjective
染まる|そまる|to dye|နီခြင်း|verb
背く|そむく|to run counter to, to go against|ကန့်ကားခြင်း|verb
染める|そめる|to dye, to colour|နီစေခြင်း|verb
逸らす|そらす|to turn away, to avert|ကျဆုံးခြင်း|verb
反り|そり|warp, curvature, curve, arch|အကွေးအခြင်း|noun
其れ|それ|it, that|ဒီ|pronoun
其れから|それから|and then, after that|ထိုနောက်|adverb
各々|それぞれ|each, every|တစ်ခြင်းတစ်သည်|adverb
其れで|それで|and, thereupon, because of that|သို့သော်|adverb
其れでは|それでは|in that situation, well then|ဒါဆိုလျှင်|adverb
其れでも|それでも|but, and yet, nevertheless|သို့သော်လည်း|adverb
其れ共|それとも|or, or else|သို့တည်းမဟုတ်|adverb
其れに|それに|besides, moreover|အပြင်တွင်|adverb
其れ程|それほど|to that degree, extent|ယင်းလောက်|adverb
其れ故|それゆえ|therefore, for that reason|ယင်းကြောင့်|adverb
揃い|そろい|set, suit, uniform|အအုပ်အစုံ|noun
徐々|そろそろ|gradually, steadily, quietly|နှေးနှေးမြန်လျင်|adverb
損失|そんしつ|loss|ဆုံးရှုံးခြင်း|noun
存続|そんぞく|duration, continuance|အဆက်မပြတ်ခြင်း|noun
沿い|ぞい|along|အလျှာအလျှင်း|noun
像|ぞう|statue, image, figure, picture|ပုံတူ|noun
増強|ぞうきょう|augment, reinforce, increase|ကြီးထွားခြင်း|noun
蔵相|ぞうしょう|Minister of Finance|ငွေကြေးအုပ်ချုပ်သူ|noun
増進|ぞうしん|promoting, increase, advance|ကြီးထွားခြင်း|noun
ぞんざい|ぞんざい|rude, careless, slovenly|မသိမသာ|adjective
他意|たい|ill will, malice, another intention, secret purpose|အမုန်းအကြိုက်|noun
対応|たいおう|interaction, correspondence, coping with, dealing with|တုံ့ဆိုင်ရန်|noun
退化|たいか|degeneration, retrogression|ကျဆုံးခြင်း|noun
体格|たいかく|physique, constitution|ခန္ဓာခြင်း|noun
大概|たいがい|in general, mainly|အများအပြား|adverb
退学|たいがく|dropping out of school|ကျောင်းထွက်ခြင်း|noun
大金|たいきん|great cost|အများအငွေ|noun
待遇|たいぐう|treatment, reception|စဉ်းစားခြင်း|noun
対決|たいけつ|confrontation, showdown|မျက်နှာချင်းခြင်း|noun
体験|たいけん|personal experience|အကြုံအဖြင့်|noun
対抗|たいこう|opposition, antagonism|ကန့်ကားခြင်း|noun
対処|たいしょ|deal with, cope|အုပ်ချုပ်ခြင်း|noun
退職|たいしょク|retirement (from office)|အလုပ်ထွက်ခြင်း|noun
退治|たいじ|extermination|ဆုံးရှုံးခြင်း|noun
態勢|たいせい|attitude, conditions, preparations|အမူအရာ|noun
対談|たいだん|talk, dialogue, conversation|စကားပြောခြင်း|noun
対等|たいとう|equivalent|တူညီမှု|adjective
滞納|たいのう|non-payment, default|အငွေမပေးခြင်း|noun
対比|たいひ|contrast, comparison|နှိုင်းယှဉ်ခြင်း|noun
大部|たいぶ|most, greater, fairly, a good deal|အများအပြား|noun
対辺|たいへん|opposite side|အပြင်အဆင့်|noun
待望|たいぼう|expectant waiting|စာင့်ရှောက်ခြင်း|noun
怠慢|たいまん|negligence, procrastination, carelessness|အားမဲ့ခြင်း|noun
対面|たいめん|interview, meeting|မျက်နှာချင်းခြင်း|noun
対立|たいりつ|confrontation, opposition, antagonism|ကန့်ကားခြင်း|noun
体力|たいりょク|physical strength|ခန္ဓာအားစိုက်ခြင်း|noun
対話|たいわ|interactive, interaction, conversation|စကားပြောခြင်း|noun
耐える|たえる|to bear, to endure|သည့်တည်းခြင်း|verb
絶える|たえる|to die out, to peter out, to become extinct|ဆုံးရှုံးခြင်း|verb
堪える|たえる|to bear, to stand, to endure|သည့်တည်းခြင်း|verb
高|たか|quantity, amount, volume, number|အများအပြား|noun
高まる|たかまる|to rise, to swell, to be promoted|တက်ခြင်း|verb
焚火|たきび|fire|မီးခိုးခြင်း|noun
沢山|たくさん|many, a lot, much|အများအပြား|adjective
逞しい|たくましい|burly, strong, sturdy|ခိုင်လုံသည်|adjective
巧み|たくみ|skill, cleverness|နူပညာခြင်း|adjective
類|たぐい|a kind|အမျိုးအစား|noun
丈|たけ|height, stature, length, measure|အမြင့်အနိမ့်|noun
足し算|たしざん|addition|ပေါင်းစုံခြင်း|noun
多数決|たすうけつ|majority rule|အများအပြားမဲမြ|noun
助け|たすけ|assistance|ကူညီခြင်း|noun
携わる|たずさわる|to participate, to take part|ပါဝင်ခြင်း|verb
漂う|ただよう|to drift about, to float, to hang in air|ကျောင်းမူတည်ခြင်း|verb
館|たち|mansion, small castle|အိမ်ခန်း|noun
立方|たちかた|dancing (geisha)|အုပ်စုံခြင်း|noun
忽ち|たちまち|at once, in a moment, suddenly|တစ်ခါတစ်ခါ|adverb
立ち寄る|たちよる|to stop by, to drop in|သာယာကာလခြင်း|verb
達者|たっしゃ|skillful, in good health|ကျွမ်းကျင်သည်|adjective
達成|たっせい|achievement|အောင်မြင်ခြင်း|noun
たった|たった|only, merely, but, no more than|သာ|adverb
尊い|たっとい|precious, valuable, priceless, noble|မြတ်မြုံသည်|adjective
貴い|たっとい|precious, valuable, priceless, noble|မြတ်မြုံသည်|adjective
尊ぶ|たっとぶ|to value, to prize, to esteem|လေးစားခြင်း|verb
絶つ|たつ|to sever, to cut off, to suppress, to abstain|ခွဲခြားခြင်း|verb
盾|たて|shield, buckler, escutcheon, pretext|ကာကွယ်ခြင်း|noun
建前|たてまえ|face, official stance, public position|အယ်ဒိုက်|noun
奉る|たてまつる|to offer, to present, to revere|ပူးပေါင်းခြင်း|verb
例え|たとえ|example, even if, if, though|ဥပမာ|noun
仮令|たとえ|example, even if, if, though|ဥပမာ|noun
他動詞|たどうし|transitive verb|သုံးအုပ်စုံ|noun
辿り着く|たどりつく|to grope along to, to struggle on to|ရောက်ခြင်း|verb
辿る|たどる|to follow, to pursue|လိုက်သည်ခြင်း|verb
掌|たなごころ|the palm|လက်မြတ်ခြင်း|noun
楽しむ|たのしむ|to enjoy oneself|ပျော်ရွှင်ခြင်း|verb
頼み|たのみ|request, favor, reliance|အကြံအစည်|noun
煙草|たばこ|tobacco, cigarettes|သစ်သီးခြင်း|noun
度々|たびたび|often, repeatedly, frequently|အားတိုက်မြည်းခြင်း|adverb
他方|たほう|another side, different direction|အခြားအစိတ်|noun
多忙|たぼう|busy, pressure of work|အလုပ်များခြင်း|adjective
給う|たまう|to receive, to grant|လူမှုခြင်း|verb
偶に|たまに|occasionally, once in a while|ခါခါတစ်ခါ|adverb
堪らない|たまらない|intolerable, unbearable, unendurable|သည့်မခံရ|adjective
溜まり|たまり|collected things, gathering place, arrears|စုဆောင်းခြင်း|noun
賜る|たまわる|to grant, to bestow|လူမှုခြင်း|verb
例|ためし|instance, example, case, precedent|ဥပမာ|noun
躊躇う|ためらう|to hesitate|သည့်တည်းခြင်း|verb
保つ|たもつ|to keep, to preserve, to hold, to retain|ကိုင်သည်ခြင်း|verb
容易い|たやすい|easy, simple, light|လွယ်ကူသည်|adjective
多様|たよう|diversity, variety|အမျိုးမျိုး|noun
弛み|たるみ|slack, slackening, dullness, letdown|အားကျခြင်း|noun
弛む|たるむ|to slacken, to loosen, to relax|အားကျခြင်း|verb
誰|たれ|adjectival suffix for a person|ကိုယ်တိုင်|pronoun
垂れる|たれる|to hang, to droop, to drop, to lower|လျှော့ကျခြင်း|verb
歎|たん|grief, sigh, lamentation|အမူအရာ|noun
反|たん|roll of cloth|အခြင်းအခြင်း|noun
単一|たんいつ|single, simple, sole, individual|တစ်ခွင်တည်း|adjective
短歌|たんか|tanka, 31-syllable Japanese poem|စာကပုံစံ|noun
担架|たんか|stretcher, litter|အဆောင်အကုံး|noun
短気|たんき|quick temper|အမုန်းအကြိုက်|noun
探検|たんけん|exploration, expedition|စူးစမ်းခြင်း|noun
短縮|たんしゅく|shortening, abbreviation, reduction|လျော့ချခြင်း|noun
箪笥|たんす|chest of drawers|သိုလှောင်ခန်း|noun
炭素|たんそ|carbon (C)|ကာဗွန်|noun
短大|たんだい|junior college|ကျောင်းအတန်း|noun
単調|たんちょう|monotony, monotone, dullness|တစ်မျိုးတည်း|adjective
単独|たんどく|sole, independence, single, solo|တစ်ခွင်တည်း|adjective
短波|たんぱ|short wave|ဒီဋ်ခလ်|noun
蛋白質|たんぱくしつ|protein|ပရိုတင်း|noun
第|だい|ordinal|အလိုက်တစ်ခြင်း|noun
第一|だいいち|first, foremost|ပထမဆုံး|adjective
大胆|だいたん|bold, daring, audacious|담ြံုကောက်ခြင်း|adjective
台無し|だいなし|mess, spoiled, nothing|စုံတွေးခြင်း|noun
大便|だいべん|feces, excrement|အဆီအကြေး|noun
代弁|だいべん|pay by proxy, act for another, speak for another|စုံလင်စကားပြောခြင်း|noun
台本|だいほん|libretto, scenario|စာသားပုံစံ|noun
代用|だいよう|substitution|အစားထိုးခြင်း|noun
打開|だかい|break in the deadlock|အဖြေခြင်း|noun
妥協|だきょう|compromise, giving in|သဘောတူညီခြင်း|noun
丈|だけ|only, just, as|သာ|particle
妥結|だけつ|agreement|သဘောတူညီခြင်း|noun
打撃|だげき|blow, shock, strike, damage|တုန်လှုပ်ခြင်း|noun
駄作|ださく|poor work, rubbish|အားမဲ့အလုပ်|noun
脱出|だっしゅつ|escape|ထွက်ပြန်ခြင်း|verb
脱する|だっする|to escape from, to get out|ထွက်ခွာခြင်း|verb
脱退|だったい|secession|ခွဲခြားခြင်း|noun
だぶだぶ|だぶだぶ|loose, baggy|ရည့ခြင်း|adjective
騙す|だます|to trick, to cheat, to deceive|လိမ်လည်ခြင်း|verb
だらけ|だらけ|implying negatively that something is full of|အပြည့်အစုံ|adverb
怠い|だるい|sluggish, feel heavy, languid, dull|အားမဲ့သည်|adjective
壇|だん|platform, podium, rostrum|စံုများခြင်း|noun
団結|だんけつ|unity, union, combination|စည်းကုံခြင်း|noun
断言|だんげん|declaration, affirmation|အသိအလျှောက်ခြင်း|noun
断然|だんぜん|firmly, absolutely, definitely|အတင်းအကျပ်|adverb
段々|だんだん|gradually, by degrees|အလျင်အသန့်|adverb
旦那|だんな|master (of house), husband|ရုံးအုပ်|noun
断面|だんめん|cross section|အခွင့်အလမ်း|noun
弾力|だんりょク|elasticity, flexibility|လွယ်ကူခြင်း|noun
治安|ちあん|public order|အုပ်ချုပ်ခြင်း|noun
近付く|ちかづく|to approach, to get near, to get acquainted|နီးကပ်ခြင်း|verb
違える|ちがえる|to change|ပြောင်းလဲခြင်း|verb
契る|ちぎる|to pledge, to promise, to swear|誓うခြင်း|verb
畜産|ちくさん|animal husbandry|တိရိစ္ဆာန်ရearing|noun
畜生|ちくしょう|beast, brute, damn|တိရိစ္ဆာန်|noun
蓄積|ちくせき|accumulation, accumulate, store|စုဆောင်းခြင်း|noun
知性|ちせい|intelligence|အဉာဏ်|noun
乳|ちち|milk, breast, loop|နို|noun
父母|ちちはは|father and mother, parents|အဖအမ|noun
縮まる|ちぢまる|to be shortened, to be contracted, to shrink|ငယ်ငယ်ခြင်း|verb
窒息|ちっそク|suffocation|မုံ့လျက်ခြင်း|noun
些とも|ちっとも|not at all|အတုံးအလုံးမဟုတ်|adverb
秩序|ちつじょ|order, regularity, system, method|စည်းကမ်းသည်|noun
知的|ちてき|intellectual|အဉာဏ်ကဲ့သည်|adjective
著|ちゃく|counter for suits of clothing|အဝတ်အစည်း|noun
着|ちゃく|counter for suits of clothing|အဝတ်အစည်း|noun
着手|ちゃくしゅ|embarkation, launch|စတင်ခြင်း|noun
着色|ちゃくしょク|colouring, coloring|အရောင်မျိုးခြင်း|noun
着席|ちゃくせき|sit down, seat|ထိုင်ခြင်း|verb
着目|ちゃくもك|attention|အာရုံခြင်း|noun
着陸|ちゃくりく|landing, alighting, touch down|ကုန်းသို့ကျခြင်း|noun
着工|ちゃっこう|start of construction work|စတင်ခြင်း|noun
茶の間|ちゃのま|living room (Japanese style)|အခန်း|noun
茶の湯|ちゃのゆ|tea ceremony|အခြင်းအခြင်း|noun
ちやほや|ちやほや|pamper, make a fuss of, spoil|စောင့်ရှောက်ခြင်း|verb
昼間|ちゅうかん|daytime, during the day|နေ့အချိန်|noun
宙返り|ちゅうがえり|somersault, looping-the-loop|လှည့်ကောက်ခြင်း|noun
中継|ちゅうけい|relay, hook-up|အလယ်အလတ်|noun
忠告|ちゅうこく|advice, warning|အကြံအစည်|noun
中指|ちゅうし|middle finger|လက်သည့်ခြင်း|noun
中傷|ちゅうしょう|slander, libel, defamation|အန္တရာယ်တင်ခြင်း|noun
忠実|ちゅうじつ|fidelity, faithfulness|သစ္စာခြင်း|adjective
中枢|ちゅうすう|centre, pivot, mainstay, nucleus|အကdouglas့း|noun
抽選|ちゅうせん|lottery, raffle, drawing|စံုများခြင်း|noun
中断|ちゅうだん|interruption, suspension, break|အနှပ်အဆန့်ခြင်း|noun
中腹|ちゅうっぱら|irritated, offended|အကြီးအလယ်|noun
中毒|ちゅうどく|poisoning|အတောင်းတောင်းခြင်း|noun
仲人|ちゅうにん|go-between, matchmaker|အလယ်အလတ်သူ|noun
昼飯|ちゅうはん|lunch, midday meal|နေ့လုံးစားအဝ|noun
中立|ちゅうりつ|neutrality|အလယ်အလတ်သည်|noun
中和|ちゅうわ|neutralize, counteract|နှီးခြင်း|noun
腸|ちょう|guts, bowels, intestines|အူ|noun
蝶|ちょう|butterfly|လိပ်ပြောင်|noun
超|ちょう|super-, ultra-, hyper-|အကျော်အသိ|prefix
庁|ちょう|government office|အစိုးရရုံး|noun
調印|ちょういん|signature, sign, sealing|လက်မှတ်ခြင်း|noun
聴覚|ちょうかく|the sense of hearing|နားအာရုံ|noun
長官|ちょうかん|chief, government secretary|အုပ်ချုပ်သူ|noun
聴講|ちょうこう|lecture attendance, auditing|သင်ခြင်း|noun
徴収|ちょうしゅう|collection, levy|စုဆောင်းခြင်း|noun
聴診器|ちょうしんき|stethoscope|နားကြည့်သည်|noun
挑戦|ちょうせん|challenge, defiance|စိန်ခေါ်ခြင်း|noun
長大|ちょうだい|very long, great length|အရှည်အမြင့်|adjective
調停|ちょうてい|arbitration, conciliation, mediation|ညီမွေးခြင်း|noun
恰度|ちょうど|just, right, exactly|ယင်းအတိုင်း|adverb
長編|ちょうへん|long (e.g. novel film)|အရှည်အရှည်|noun
丁目|ちょうめ|district of a town, city block|သိုင်းခိုင်း|noun
調理|ちょうり|cooking|ချက်ပြုတ်ခြင်း|noun
調和|ちょうわ|harmony|သဟဝတ်ခြင်း|noun
ちょくちょく|ちょくちょく|often, frequently, now and then|အားတိုက်မြည်းခြင်း|adverb
直面|ちょくめん|confrontation|မျက်နှာချင်းခြင်း|noun
著書|ちょしょ|literary work, book|စာအုပ်|noun
貯蓄|ちょちく|savings|စုဆောင်းခြင်း|noun
直感|ちょっかん|intuition|အကြံအစည်တစ်ခြင်း|noun
一寸|ちょっと|just a minute, a short time, a while|အလျင်အသန့်|adverb
著名|ちょめい|well-known, noted, celebrated|ကျော်ကျိုးခြင်း|adjective
ちらっと|ちらっと|at a glance, by accident|အကျယ်တဝက်|adverb
塵取り|ちりとり|dustpan|အညစ်အကြေးဒူး|noun
治療|ちりょう|medical treatment|ကုသခြင်း|noun
賃金|ちんぎん|wages|လစာခြင်း|noun
沈殿|ちんでん|precipitation, settlement|နစ်မြုပ်ခြင်း|noun
沈没|ちんぼつ|sinking, foundering|လုံးဝနစ်မြုပ်ခြင်း|noun
沈黙|ちんもく|silence, reticence|တိတ်တဆိတ်မှု|noun
陳列|ちんれつ|exhibition, display, show|အလှတင်ခြင်း|noun
追及|ついきゅう|gaining on, carrying out, solving|ခိုင်လုံစွာဆုံးခြင်း|noun
追跡|ついせき|pursuit|လိုက်စားခြင်း|noun
次いで|ついで|next, secondly, subsequently|နောက်ဆုံး|adverb
追放|ついほう|exile, banishment|နှုတ်ယူခြင်း|noun
費やす|ついやす|to spend, to devote, to waste|သုံးစွဲခြင်း|verb
墜落|ついらく|falling, crashing|ကျခြင်း|noun
通|つう|connoisseur, counter for letters|စာ|noun
痛感|つうかん|feeling keenly, fully realizing|အလျင်းအမြင်း|noun
通常|つうじょう|common, general, usually|ထုံးစံ|adjective
痛切|つうせつ|keen, acute|အကြီးအမွေးခြင်း|adjective
杖|つえ|cane|တံတား|noun
遣い|つかい|mission, simple task, doing|အလုပ်ခြင်း|noun
使い道|つかいみち|use|အသုံးခြင်း|noun
仕える|つかえる|to serve, to work for|အလုပ်စောင့်ခြင်း|verb
司る|つかさどる|to rule, to govern, to administer|အုပ်ချုပ်ခြင်း|verb
束の間|つかのま|moment, brief time, brief, transient|အချိန်သည်|noun
付き|つき|attached to, impression, sociality|သုံးစွဲခြင်း|noun
付き合う|つきあう|to associate with, to keep company|မိတ်ဆက်ခြင်း|verb
月並み|つきなみ|every month, common|ပုံမှန်သည်|adjective
尽きる|つきる|to be used up, to be run out, to be exhausted|သုံးဆုံးခြင်း|verb
継ぎ目|つぎめ|a joint, joining point|ချိုးခြင်း|noun
吐く|つく|to breathe, to tell, to vomit|အသံထွက်ခြင်း|verb
尽くす|つくす|to exhaust, to run out, to serve|သုံးဆုံးခြင်း|verb
作り|つくり|make-up, sliced raw fish|ပြုလုပ်ခြင်း|noun
造り|つくり|make up, structure, physique|ပုံသဏ္ဍာန်|noun
造る|つくる|to make, to create, to manufacture, to draw up|ပြုလုပ်ခြင်း|verb
繕う|つくろう|to mend, to repair, to fix, to patch up|ပြင်ဆင်ခြင်း|verb
接ぐ|つぐ|to join, to piece together, to set|တွဲဆက်ခြင်း|verb
継ぐ|つぐ|to succeed|ဆက်လက်ခြင်း|verb
付け加える|つけくわえる|to add one thing to another|ပေါင်းထည့်ခြင်း|verb
告げる|つげる|to inform|အသိပေးခြင်း|verb
辻褄|つじつま|coherence, consistency|သဘောတူညီခြင်း|noun
途中|つちゅう|on the way, en route|လမ်းတစ်ဝက်|noun
突く|つつく|to thrust, to strike, to attack, to poke|နှက်ခြင်း|verb
慎む|つつしむ|to be careful, to be chaste or discreet|သတိထားခြင်း|verb
伝言|つてごと|verbal message, rumor, word|သတင်းပြောခြင်း|noun
勤まる|つとまる|to be fit for, to be equal to|အဆင်အလိုသည်|verb
勤め先|つとめさき|place of work|အလုပ်ခန်း|noun
努めて|つとめて|make an effort, work hard|အလုပ်စောင့်ခြင်း|adverb
津波|つなみ|tsunami, tidal wave|ရေလှိုင်း|noun
抓る|つねる|to pinch|နှိပ်ခြင်း|verb
募る|つのる|to invite, to solicit help participation|အသိအလျှောက်ခြင်း|verb
唾|つば|saliva, sputum|အအူခြင်း|noun
呟く|つぶやく|to mutter, to murmur|အသံခိုင်းခြင်း|verb
瞑る|つぶる|to close the eyes|မျက်မှန်ပိတ်ခြင်း|verb
壷|つぼ|tsubo jar, pot, vase|ပိုက်ဆင်း|noun
蕾|つぼみ|bud, flower bud|ပန်းပွင့်မည်|noun
躓く|つまずく|to stumble, to trip|လဲခြင်း|verb
摘む|つまむ|to pinch, to hold, to pick up|ကိုင်ခြင်း|verb
詰らない|つまらない|insignificant, boring, trifling|အစွဲမရ|adjective
詰まり|つまり|in short, in brief, in other words|ယင်းကြောင့်|adverb
積もり|つもり|intention, plan|သည်သည်တည်းဝယ်ခြင်း|noun
露|つゆ|dew|နှင်း|noun
連なる|つらなる|to extend, to stretch out, to stand in a row|တစ်တန်းတည်းရပ်သည်၊ ဆက်စပ်နေသည်|verb
貫く|つらぬく|to go through|ဖောက်သွားသည်၊ ချိုးဖောက်သည်|verb
連ねる|つらねる|to link, to join, to put together|ချိတ်ဆက်သည်၊ ပေါင်းစည်းသည်|verb
釣り|つり|fishing, angling|ငါးမျှားခြင်း|noun
吊り革|つりかわ|strap|လက်ကိုင်ကြိုး|noun
釣鐘|つりがね|hanging bell|ချိတ်ဆွဲခေါင်းလောင်း|noun
吊るす|つるす|to hang|ချိတ်ဆွဲသည်|verb
手当て|てあて|allowance, compensation, treatment, medical care|ထောက်ပံ့ကြေး၊ ကုသမှု|noun
体|てい|appearance, air, condition, state, form|အသွင်အပြင်၊ အခြေအနေ|noun
提供|ていきょう|offer, tender, program sponsoring, furnishing|ကမ်းလှမ်းခြင်း၊ ပံ့ပိုးခြင်း|noun
定義|ていぎ|definition|အဓိပ္ပါယ်ဖွင့်ဆိုချက်|noun
提携|ていけい|cooperation, tie-up, joint business, link-up|ပူးပေါင်းဆောင်ရွက်ခြင်း|noun
体裁|ていさい|decency, style, form, appearance, show, get-up, format|ပုံစံ၊ အသွင်အပြင်|noun
梯子|ていし|ladder, stairs|လှေကား၊ ထစ်လှေကား|noun
定食|ていしょく|set meal, special (of the day)|စုံစမ်းထမင်းစာ|noun
提示|ていじ|presentation, exhibit, suggest, citation|တင်ပြခြင်း၊ ပြသခြင်း|noun
訂正|ていせい|correction, revision|ပြင်ဆင်ခြင်း|noun
停滞|ていたい|stagnation, tie-up, congestion, retention, accumulation|ရပ်တန့်ခြင်း၊ စုပုံခြင်း|noun
邸宅|ていたく|mansion, residence|အိမ်ကြီး၊ နေအိမ်|noun
定年|ていねん|retirement age|အနားယူသက်တမ်း|noun
堤防|ていぼう|bank, weir|တံတား၊ ရေကာတံတား|noun
手遅れ|ておくれ|too late, belated treatment|နောက်ကျခြင်း|noun
手数|てかず|number of moves, trouble|အဆင့်အရေအတွက်၊ အခက်အခဲ|noun
手掛かり|てがかり|contact, trail, scent, on hand, hand hold, clue, key|သဲလွန်စ၊ အထောက်အထား|noun
手掛ける|てがける|to handle, to manage, to work with, to rear, to look after|စီမံသည်၊ ကိုင်တွယ်သည်|verb
手軽|てがる|easy, simple, informal, offhand, cheap|လွယ်ကူသော၊ ရိုးရှင်းသော|adjective
的|てき|-like, typical|သဏ္ဌာန်၊ ပုံစံ|suffix
適応|てきおう|adaptation, accommodation, conformity|လိုက်လျောညီထွေဖြစ်ခြင်း|noun
適宜|てきぎ|suitability|သင့်လျော်မှု|noun
適性|てきせい|aptitude|စွမ်းရည်၊ အရည်အချင်း|noun
手際|てぎわ|performance, skill, tact|ကျွမ်းကျင်မှု၊ လုပ်ပုံ|noun
手順|てじゅん|process, procedure, protocol|လုပ်ငန်းစဉ်|noun
手錠|てじょう|handcuffs, manacles|လက်ကျောက်|noun
手近|てぢか|near, handy, familiar|အနီး၊ လက်လှမ်းမီသော|adjective
てっきり|てっきり|surely, certainly, beyond doubt|သေချာစွာ၊ ဧကန်မုချ|adverb
鉄鋼|てっこう|iron and steel|သံမဏိနှင့်သံမဏိ|noun
徹する|てっする|to sink in, to penetrate, to devote oneself, to believe in|စွဲမြဲစွာလုပ်သည်၊ ဖောက်ထွင်းသည်|verb
鉄片|てっぺん|iron scraps|သံအပိုင်းအစများ|noun
手配|てはい|arrangement, search (by police)|စီစဉ်ခြင်း၊ ရှာဖွေခြင်း|noun
手筈|てはず|arrangement, plan, programme|အစီအစဉ်၊ အစီအမံ|noun
手引き|てびき|guidance, guide, introduction|လမ်းညွှန်ခြင်း|noun
手本|てほん|model, pattern|ပုံစံ၊ နမူနာ|noun
手回し|てまわし|preparations, arrangements|ကြိုတင်ပြင်ဆင်ခြင်း|noun
手元|てもと|on hand, at hand, at home|လက်ဝယ်၊ လက်ရှိ|noun
照り返す|てりかえす|to reflect, to throw back light|ရောင်ပြန်ဟပ်သည်|verb
手分け|てわけ|division of labour|လုပ်ငန်းခွဲဝေခြင်း|noun
店|てん|store, shop, establishment|ဆိုင်|noun
点火|てんか|ignition, lighting, set fire to|မီးညှိခြင်း|noun
転回|てんかい|revolution, rotation|လှည့်ပတ်ခြင်း|noun
転換|てんかん|convert, divert|ပြောင်းလဲခြင်း|noun
転居|てんきょ|moving, changing residence|နေရပ်ပြောင်းခြင်း|noun
転勤|てんきん|transfer, transmission|ရွေ့ပြောင်းခြင်း|noun
点検|てんけん|inspection, examination, checking|စစ်ဆေးခြင်း|noun
転校|てんこう|change schools|ကျောင်းပြောင်းခြင်း|noun
天国|てんごく|paradise, heaven, Kingdom of Heaven|ကောင်းကင်ဘုံ|noun
天才|てんさい|genius, prodigy, natural gift|ပါရမီရှင်၊ ထူးချွန်သူ|noun
天災|てんさい|natural calamity, disaster|သဘာဝဘေး|noun
展示|てんじ|exhibition, display|ပြသခြင်း|noun
天井|てんじょう|ceiling, ceiling price|မျက်နှာကြက်|noun
転じる|てんじる|to turn, to shift, to alter, to distract|ပြောင်းလဲသည်|verb
点線|てんせん|dotted line, perforated line|အစက်မျဉ်း|noun
天体|てんたい|heavenly body|နက္ခတ်|noun
転転|てんてん|rolling about, moving from place to place|လှိမ့်လှိမ့်၊ နေရာမှနေရာ|adverb
てんで|てんで|(not) at all, altogether, entirely|လုံးဝ၊ လုံးလုံး|adverb
転任|てんにん|change of post|ရာထူးပြောင်းခြင်း|noun
展望|てんぼう|view, outlook, prospect|ရှုခင်း၊ အလားအလာ|noun
転落|てんらく|fall, degradation, slump|ကျဆင်းခြင်း|noun
出合う|であう|to meet by chance, to come across|မတော်တဆတွေ့ဆုံသည်|verb
出入り口|でいりぐち|exit and entrance|ဝင်ပေါက်နှင့်ထွက်ပေါက်|noun
でかい|でかい|huge|ကြီးမားသော|adjective
出来物|できもの|able man, tumour, growth, boil, ulcer, abcess, rash, pimple|အရည်ပူ၊ အဖုအထစ်|noun
出切る|できる|to be out of, to have no more at hand|ကုန်သည်၊ ကုန်ဆုံးသည်|verb
出くわす|でくわす|to happen to meet, to come across|မတော်တဆတွေ့သည်|verb
出鱈目|でたらめ|irresponsible utterance, nonsense, nonsensical, random, haphazard|စပ်ကြွ၊ အဓိပ္ပာယ်မဲ့|noun
出直し|でなおし|adjustment, touch up|ပြန်လည်ပြင်ဆင်ခြင်း|noun
田園|でんえん|country, rural districts|ကျေးလက်ဒေသ|noun
電源|でんげん|source of electricity, power (button on TV etc.)|လျှပ်စစ်အရင်းအမြစ်|noun
伝説|でんせつ|tradition, legend, folklore|ဒဏ္ဍာရီ၊ ရိုးရာပုံပြင်|noun
電線|でんせん|electric line|လျှပ်စစ်ကြိုး|noun
伝達|でんたつ|transmission (e.g. news), communication, delivery|ဆက်သွယ်ခြင်း၊ ပို့လွှတ်ခြင်း|noun
伝来|でんらい|ancestral, hereditary, imported, transmitted, handed down|လက်ဆင့်ကမ်းရရှိခြင်း|noun
と|と|if (conjunction), promoted pawn (shogi)|အကယ်၍|conjunction
問い合わせる|といあわせる|to enquire, to seek information|မေးမြန်းသည်|verb
問屋|といや|wholesale store|လက်ကားဆိုင်|noun
問う|とう|to ask, to question, to charge (i.e. with a crime), to accuse|မေးမြန်းသည်၊ စွပ်စွဲသည်|verb
棟|とう|place, section, building|အဆောက်အအုံ|noun
等|とう|et cetera, etc., and the like|စသည်ဖြင့်|suffix
陶器|とうき|pottery, ceramics|မြေအိုးထည်|noun
等級|とうきゅう|grade, class|အဆင့်|noun
討議|とうぎ|debate, discussion|ဆွေးနွေးငြင်းခုံခြင်း|noun
登校|とうこう|attendance (at school)|ကျောင်းတက်ရောက်ခြင်း|noun
統合|とうごう|integration, unification, synthesis|ပေါင်းစည်းခြင်း|noun
倒産|とうさん|(corporate) bankruptcy, insolvency|ဒေဝါလီခံခြင်း|noun
投資|とうし|investment|ရင်းနှီးမြှုပ်နှံခြင်း|noun
統治|とうじ|rule, reign, government, governing|အုပ်ချုပ်ခြင်း|noun
統制|とうせい|regulation, control|ထိန်းချုပ်ခြင်း|noun
当選|とうせん|being elected, winning the prize|ရွေးကောက်တင်မြှောက်ခြင်း|noun
逃走|とうそう|flight, desertion, escape|ထွက်ပြေးခြင်း|noun
統率|とうそつ|command, lead, generalship, leadership|ခေါင်းဆောင်ခြင်း|noun
到達|とうたつ|reaching, attaining, arrival|ရောက်ရှိခြင်း|noun
到底|とうてい|(cannot) possibly|လုံးဝမဖြစ်နိုင်|adverb
丁々|とうとう|clashing of swords, felling of trees, ringing of an ax|နောက်ဆုံး၊ အဆုံးတွင်|adverb
投入|とうにゅう|throw, investment, making (an electrical circuit)|ထည့်သွင်းခြင်း|noun
当人|とうにん|the one concerned, the said person|သက်ဆိုင်သူ|noun
逃亡|とうぼう|escape|ထွက်ပြေးခြင်း|noun
冬眠|とうみん|hibernation, winter sleep|ဆောင်းခိုခြင်း|noun
登録|とうろく|registration, register, entry, record|မှတ်ပုံတင်ခြင်း|noun
討論|とうろん|debate, discussion|ဆွေးနွေးငြင်းခုံခြင်း|noun
遠ざかる|とおざかる|to go far off|ဝေးကွာသွားသည်|verb
遠回り|とおまわり|detour, roundabout way|လမ်းကွေ့၊ ရှည်လျားသောလမ်း|noun
通りかかる|とおりかかる|to happen to pass by|မတော်တဆဖြတ်သန်းသည်|verb
兎角|とかく|anyhow, anyway, somehow or other, generally speaking, in any case|သို့သော်၊ ဘာပဲဖြစ်ဖြစ်|adverb
咎める|とがめる|to blame, to find fault, to take someone to task|အပြစ်တင်သည်၊ ပြစ်တင်သည်|verb
時折|ときおり|sometimes|တခါတရံ|adverb
跡切れる|とぎれる|to pause, to be interrupted|ရပ်တန့်သည်၊ ကြားဖြတ်သည်|verb
説く|とく|to explain, to advocate, to preach, to persuade|ရှင်းပြသည်၊ ဟောကြားသည်|verb
特技|とくぎ|special skill|အထူးကျွမ်းကျင်မှု|noun
特産|とくさん|specialty, special product|အထူးထွက်ကုန်|noun
特集|とくしゅう|feature (e.g. newspaper), special edition, report|အထူးအစီအစဉ်|noun
得点|とくてん|score, points made, marks obtained, runs|ရမှတ်|noun
特派|とくは|send specially, special envoy|အထူးစေလွှတ်ခြင်း|noun
特有|とくゆう|characteristic (of), peculiar (to)|ထူးခြားသော၊ သီးသန့်|adjective
研ぐ|とぐ|to sharpen, to grind, to scour, to hone, to polish|ထက်စေသည်၊ ပွတ်တိုက်သည်|verb
刺|とげ|thorn, splinter, spine, biting words|ဆူး|noun
遂げる|とげる|to accomplish, to achieve, to carry out|အောင်မြင်သည်|verb
床|とこ|bed, sickbed, alcove, padding|အိပ်ရာ|noun
所が|ところが|however, while, even if|သို့သော်|conjunction
所で|ところで|by the way, even if, no matter what|မည်သို့ပင်ဖြစ်စေ|conjunction
年頃|としごろ|age, marriageable age, age of puberty, adolescence|အသက်အရွယ်၊ လက်ထပ်သင့်သောအရွယ်|noun
年寄り|としより|old people, the aged|သက်ကြီးရွယ်အိုများ|noun
戸締り|とじまり|closing up, fastening the doors|တံခါးပိတ်ခြင်း|noun
途上|とじょう|en route, half way|လမ်းတွင်၊ အလယ်တွင်|noun
綴じる|とじる|to bind, to file|ချုပ်သည်၊ စုစည်းသည်|verb
途絶える|とだえる|to stop, to cease, to come to an end|ရပ်တန့်သည်၊ ပြတ်သားသည်|verb
特許|とっきょ|special permission, patent|မူပိုင်ခွင့်|noun
疾っくに|とっくに|long ago, already, a long time ago|လွန်ခဲ့သောကာလကတည်းက|adverb
特権|とっけん|privilege, special right|အထူးအခွင့်အရေး|noun
咄嗟|とっさ|moment, instant|ချက်ချင်း၊ ဆတ်ခနဲ|noun
取っ手|とって|handle, grip, knob|လက်ကိုင်|noun
突破|とっぱ|breaking through, breakthrough, penetration|ဖောက်ထွင်းခြင်း|noun
突如|とつじょ|suddenly, all of a sudden|ရုတ်တရက်|adverb
迚も|とても|very, awfully, exceedingly|အလွန်|adverb
整える|ととのえる|to put in order, to get ready, to arrange, to adjust|စီစဉ်သည်၊ ပြင်ဆင်သည်|verb
届け|とどけ|report, notification, registration|အစီရင်ခံခြင်း၊ အကြောင်းကြားခြင်း|noun
滞る|とどこおる|to stagnate, to be delayed|ကြန့်ကြာသည်၊ ရပ်တန့်သည်|verb
止まる|とどまる|to be limited to|ကန့်သတ်သည်|verb
留める|とどめる|to stop, to cease, to put an end to|ရပ်တန့်သည်၊ ထိန်းထားသည်|verb
止める|とどめる|to stop, to cease, to put an end to|ရပ်တန့်သည်|verb
唱える|となえる|to recite, to chant, to call upon|ရွတ်ဆိုသည်|verb
兎に角|とにかく|anyhow, at any rate, anyway, somehow or other|သို့သော်၊ ဘာပဲဖြစ်ဖြစ်|adverb
殿様|とのさま|feudal lord|ပြည်သူ့အရှင်|noun
幕|とばり|curtain, bunting, act (in play)|ကုလားကာ|noun
帳|とばり|curtain|ကုလားကာ|noun
扉|とびら|door, opening|တံခါး|noun
徒歩|とほ|walking, going on foot|လမ်းလျှောက်ခြင်း|noun
乏しい|とぼしい|meagre, scarce, limited, destitute, hard up, scanty, poor|ရှားပါးသော၊ နည်းပါးသော|adjective
富|とみ|wealth, fortune|ကြွယ်ဝမှု|noun
富む|とむ|to be rich, to become rich|ကြွယ်ဝသည်|verb
兎も角|ともかく|anyhow, anyway, somehow or other|သို့သော်|adverb
共稼ぎ|ともかせぎ|working together, (husband and wife) earning a living together|အတူတူအလုပ်လုပ်ခြင်း|noun
灯|ともしび|light|မီးအလင်း|noun
伴う|ともなう|to accompany, to bring with, to be accompanied by, to be involved in|လိုက်ပါသည်၊ ပါဝင်သည်|verb
共働き|ともばたらき|dual income|စုပေါင်းဝင်ငွေ|noun
捕らえる|とらえる|to seize, to grasp, to capture, to arrest|ဖမ်းဆီးသည်|verb
取りあえず|とりあえず|at once, first of all, for the time being|ခဏတာ၊ ဦးစွာ|adverb
取り扱い|とりあつかい|treatment, service, handling, management|ကိုင်တွယ်ဆောင်ရွက်ခြင်း|noun
取り扱う|とりあつかう|to treat, to handle, to deal in|ကိုင်တွယ်သည်|verb
鳥居|とりい|torii (Shinto shrine archway)|တိုရိုင်းတံခါးဝ|noun
取り替え|とりかえ|swap, exchange|လဲလှယ်ခြင်း|noun
取り組む|とりくむ|to tackle, to wrestle with, to engage in a bout|ကိုင်တွယ်ဖြေရှင်းသည်|verb
取り締まり|とりしまり|control, management, supervision|ကြီးကြပ်ခြင်း|noun
取り締まる|とりしまる|to manage, to control, to supervise|ကြီးကြပ်သည်|verb
取り調べる|とりしらべる|to investigate, to examine|စုံစမ်းစစ်ဆေးသည်|verb
取り立てる|とりたてる|to collect, to extort, to appoint, to promote|စုဆောင်းသည်၊ ခန့်အပ်သည်|verb
取り次ぐ|とりつぐ|to act as an agent for, to announce (someone), to convey (a message)|ကြားခံသည်၊ အကြောင်းကြားသည်|verb
取り除く|とりのぞく|to remove, to take away, to set apart|ဖယ်ရှားသည်|verb
取り引き|とりひき|transactions, dealings, business|အရောင်းအဝယ်၊ စီးပွားရေးဆက်ဆံမှု|noun
取り巻く|とりまく|to surround, to circle, to enclose|ဝိုင်းရံသည်|verb
取り混ぜる|とりまぜる|to mix, to put together|ရောသည်|verb
取り戻す|とりもどす|to take back, to regain|ပြန်ရသည်|verb
取り寄せる|とりよせる|to order, to send away for|မှာယူသည်|verb
取り分|とりわけ|especially, above all|အထူးသျှဖြင့်|adverb
副|とりわけ|especially, above all|အထူးသျှဖြင့်|adverb
蕩ける|とろける|to be enchanted with|အရည်ပျော်သည်၊ စွဲလမ်းသည်|verb
とんだ|とんだ|terrible, awful, serious, preposterous|ဆိုးရွားသော၊ အံ့သြဖွယ်|adjective
胴|どう|trunk, body, frame|ကိုယ်လုံး|noun
働|どう|work, labor|အလုပ်|noun
同|どう|the same, the said, ibid.|တူညီသော|adjective
同意|どうい|agreement, consent, same meaning, same opinion, approval|သဘောတူညီချက်|noun
動員|どういん|mobilization|စစ်သားစုရုံးခြင်း|noun
同感|どうかん|agreement, same opinion, same feeling, sympathy, concurrence|စာနာမှု၊ သဘောတူညီမှု|noun
動機|どうき|motive, incentive|လှုံ့ဆော်ချက်|noun
同級|どうきゅう|the same grade, same class|တူတန်းသား|noun
同居|どうきょ|living together|အတူနေထိုင်ခြင်း|noun
動向|どうこう|trend, tendency, movement, attitude|လမ်းကြောင်း၊ သဘောထား|noun
同士|どうし|fellow, companion, comrade|အဖော်၊ သဘောကျသူ|noun
同志|どうし|same mind, comrade, kindred soul|သဘောတူညီသူ|noun
如何して|どうして|why?, for what reason, how, in what way, for what purpose, what for|ဘာကြောင့်|adverb
如何しても|どうしても|by all means, at any cost, no matter what|မည်သို့ပင်ဖြစ်စေ|adverb
同情|どうじょう|sympathy, compassion, sympathize, pity, feel for|စာနာမှု|noun
道場|どうじょう|dojo, hall used for martial arts training|သင်ကြားရေးခန်းမ|noun
何卒|どうぞ|please, kindly, by all means|ကျေးဇူးပြု၍|adverb
どうぞ宜しく|どうぞよろしく|pleased to meet you|တွေ့ဆုံရတာဝမ်းသာပါတယ်|phrase
同調|どうちょう|sympathy, agree with, alignment, tuning|သဘောတူညီမှု|noun
動的|どうてき|dynamic, kinetic|ရွေ့လျားမှုရှိသော|adjective
同等|どうとう|equality, equal, same rights, same rank|တူညီမျှတမှု|noun
堂々|どうどう|magnificent, grand, impressive|ခမ်းနားထည်ဝါသော|adjective
どうにか|どうにか|in some way or other, one way or another|တစ်နည်းနည်းဖြင့်|adverb
導入|どうにゅう|introduction, bringing in, leading in|မိတ်ဆက်ခြင်း|noun
同封|どうふう|enclosure (e.g. in a letter)|တွဲဖက်ပါဝင်သည်|noun
同盟|どうめい|alliance, union, league|မဟာမိတ်|noun
どうやら|どうやら|it seems like, somehow or other|ထင်ရသည်မှာ|adverb
動揺|どうよう|disturbance, unrest, shaking, trembling, pitching, rolling, oscillation, agitation|တုန်လှုပ်ခြင်း|noun
動力|どうりょく|power, motive power, dynamic force|စွမ်းအား|noun
独裁|どくさい|dictatorship, despotism|အာဏာရှင်စနစ်|noun
読者|どくしゃ|reader|စာဖတ်သူ|noun
独自|どくじ|original, peculiar, characteristic|မိမိပိုင်၊ ထူးခြားသော|adjective
独占|どくせん|monopoly|လက်ဝါးကြီးအုပ်ခြင်း|noun
独創|どくそう|originality|မူရင်းဖန်တီးမှု|noun
何処|どこ|where, what place|ဘယ်မှာ|pronoun
何処か|どこか|somewhere, anywhere, in some respects|တစ်နေရာရာ|adverb
土産|どさん|product of the land|အထွက်ကုန်|noun
土台|どだい|foundation, base, basis|အခြေခံ၊ တည်ဆောက်ချက်|noun
何方|どちら|which, who|ဘယ်သူ၊ ဘယ်ဟာ|pronoun
土手|どて|embankment, bank|ဆည်ပြင်|noun
何方|どなた|who?|ဘယ်သူလဲ|pronoun
怒鳴る|どなる|to shout, to yell|အော်ဟစ်သည်|verb
何の|どの|which, what|ဘယ်|pronoun
土俵|どひょう|arena|ရင်ပွဲကွင်း|noun
土木|どぼく|public works|အများပြည်သူအလုပ်|noun
何れ|どれ|well, now, let me see, which (of three or more)|ဘယ်ဟာလဲ|pronoun
何々|どれどれ|which (emphatic)|ဘယ်ဟာလဲကွ|pronoun
度忘れ|どわすれ|lapse of memory, forget for a moment|ခဏမေ့ခြင်း|noun
鈍感|どんかん|thickheadedness, stolidity|ခံစားမှုနည်းခြင်း|noun
内閣|ないかく|cabinet, (government) ministry|အစိုးရအဖွဲ့|noun
乃至|ないし|from...to, between...and, or|မှ...အထိ|particle
内臓|ないぞう|internal organs, intestines, viscera|အတွင်းအင်္ဂါ|noun
内部|ないぶ|interior, inside, internal|အတွင်းပိုင်း|noun
内乱|ないらん|civil war, insurrection, rebellion, domestic conflict|ပြည်တွင်းစစ်|noun
内陸|ないりく|inland|ကုန်းတွင်းပိုင်း|noun
苗|なえ|rice seedling|ပျိုးပင်|noun
尚|なお|furthermore, still, yet, more, still more|ထို့အပြင်|adverb
尚更|なおさら|all the more, still less|ပို၍|adverb
中程|なかほど|middle, midway|အလယ်ပိုင်း|noun
流し|ながし|sink|ရေချိုးခန်းစင်|noun
長々|ながなが|long, drawn-out, very long|ရှည်လျားသော|adjective
殴る|なぐる|to strike, to hit|ရိုက်သည်|verb
嘆く|なげく|to sigh, to lament, to grieve|ညည်းညူသည်|verb
投げ出す|なげだす|to throw down, to abandon, to sacrifice, to throw out|ပစ်ချသည်၊ စွန့်လွှတ်သည်|verb
和やか|なごやか|mild, calm, gentle, quiet, harmonious|ငြိမ်းချမ်းသော|adjective
名残|なごり|remains, traces, memory|အကြွင်းအကျန်|noun
情け|なさけ|sympathy, compassion|စာနာမှု|noun
情け深い|なさけぶかい|tender-hearted, compassionate|စာနာတတ်သော|adjective
為さる|なさる|to do|လုပ်သည်|verb
詰る|なじる|to rebuke, to scold, to tell off|ဆူပူသည်|verb
何故|なぜ|why, how|ဘာကြောင့်|adverb
何故なら|なぜなら|because|အဘယ်ကြောင့်ဆိုသော်|conjunction
名高い|なだかい|famous, celebrated, well-known|နာမည်ကြီးသော|adjective
雪崩|なだれ|avalanche|မိုးပြင်းမုန်တိုင်း|noun
懐く|なつく|to become emotionally attached|ရင်းနှီးသည်|verb
名付ける|なづける|to name (someone)|အမည်ပေးသည်|verb
何気ない|なにげない|casual, unconcerned|သတိမထားမိသော|adjective
何しろ|なにしろ|at any rate, anyhow, anyway, in any case|ဘာပဲဖြစ်ဖြစ်|adverb
何卒|なにとぞ|please|ကျေးဇူးပြု၍|adverb
何も|なにも|nothing|ဘာမျှ|pronoun
何より|なにより|most, best|အကောင်းဆုံး|adverb
七日|なぬか|seven days, the seventh day (of the month)|ခုနစ်ရက်|noun
名札|なふだ|name plate, name tag|အမည်ကဒ်|noun
生臭い|なまぐさい|smelling of fish or blood, fish or meat|အသားအငါးအနံ့|adjective
生温い|なまぬるい|lukewarm, halfhearted|ရေနွေးနွေး|adjective
生身|なまみ|living flesh, flesh and blood, the quick|ရှင်သူ၊ အသားအရေ|noun
鉛|なまり|lead (the metal)|ခဲ|noun
鈍る|なまる|to become less capable, to grow dull, to become blunt, to weaken|ထိုးသော့သည်|verb
並み|なみ|average, medium, common, ordinary|ပျမ်းမျှ|noun
滑らか|なめらか|smoothness, glassiness|ချောမွေ့သော|adjective
嘗める|なめる|to lick, to taste, to experience|လျက်သည်|verb
悩ましい|なやましい|seductive, melancholy, languid|စိတ်ညစ်စရာ|adjective
悩ます|なやます|to afflict, to torment, to harass, to molest|စိတ်ညစ်စေသည်|verb
悩み|なやみ|trouble(s), worry, distress, anguish, agony, problem|စိတ်ပူပန်မှု|noun
平均|ならし|equilibrium, balance, average, mean|ပျမ်းမျှ|noun
慣らす|ならす|to accustom|လေ့ကျင့်သည်|verb
馴らす|ならす|to domesticate, to tame|အလေ့အကျင့်ပေးသည်|verb
並びに|ならびに|and|နှင့်|conjunction
成り立つ|なりたつ|to conclude, to consist of, to be practical|ဖွဲ့စည်းထားသည်|verb
成る丈|なるたけ|as much as possible, if possible|တတ်နိုင်သမျှ|adverb
成るべく|なるべく|as much as possible|တတ်နိုင်သမျှ|adverb
慣れ|なれ|practice, experience|အတွေ့အကြုံ|noun
馴れ馴れしい|なれなれしい|over-familiar|ရင်းနှီးလွန်းသော|adjective
難|なん|difficulty, hardships, defect|အခက်အခဲ|noun
南|なん|south|တောင်|noun
なんか|なんか|things like ..., or something like that|စသည်တို့|particle
何だか|なんだか|a little, somewhat, somehow|တစ်ခုခုပမာ|adverb
なんだかんだ|なんだかんだ|something or other|တစ်ခုမဟုတ်တစ်ခု|phrase
何て|なんて|how...!, what...!|ဘယ်လောက်...!|adverb
何と|なんと|what, how, whatever|ဘာလဲ|adverb
何となく|なんとなく|somehow or other, for some reason or another|တစ်နည်းနည်းနဲ့|adverb
何とも|なんとも|nothing (with neg. verb), quite, not a bit|လုံးဝ|adverb
何なり|なんなり|any, anything, whatever|မည်သည့်အရာမဆို|pronoun
荷|に|load, baggage, cargo|ဝန်|noun
似通う|にかよう|to resemble closely|ဆင်တူသည်|verb
面皰|にきび|pimple, acne|အရည်ပူ|noun
賑わう|にぎわう|to prosper, to flourish, to do thriving business, to be crowded with people|စည်ကားသည်|verb
悪い|にくい|hateful, abominable, poor-looking|မုန်းတီးဖွယ်|adjective
憎しみ|にくしみ|hatred|မုန်းတီးမှု|noun
肉親|にくしん|blood relationship, blood relative|သွေးသားဆွေမျိုး|noun
肉体|にくたい|the body, the flesh|ကိုယ်ခန္ဓာ|noun
逃げ出す|にげだす|to run away, to escape from|ထွက်ပြေးသည်|verb
西日|にしび|westering sun|အနောက်နေ|noun
滲む|にじむ|to run, to blur, to spread, to blot, to ooze|စိမ့်ဝင်သည်|verb
日夜|にちや|day and night, always|နေ့ညမပြတ်|noun
日当|にっとう|daily allowance|နေ့စားလုပ်ခ|noun
荷造り|にづくり|packing, baling, crating|ထုပ်ပိုးခြင်း|noun
担う|になう|to carry on shoulder, to bear (burden), to shoulder (gun)|ပခုံးပေါ်တင်သည်|verb
二人|ににん|two persons, two people, pair, couple|လူနှစ်ယောက်|noun
にも拘らず|にもかかわらず|in spite of, nevertheless|သို့သော်လည်း|conjunction
入手|にゅうしゅ|obtaining, coming to hand|ရရှိခြင်း|noun
入賞|にゅうしょう|winning a prize or place (in a contest)|ဆုရခြင်း|noun
入浴|にゅうよく|bathe, bathing|ရေချိုးခြင်း|noun
尿|にょう|urine|ဆီး|noun
俄か|にわか|sudden, abrupt, unexpected, improvised, offhand|ရုတ်တရက်|adjective
認識|にんしき|recognition, cognizance|အသိအမှတ်ပြုမှု|noun
妊娠|にんしん|conception, pregnancy|ကိုယ်ဝန်|noun
人情|にんじょう|humanity, empathy, kindness, sympathy|လူ့ဂုဏ်သိက္ခာ|noun
任務|にんむ|duty, function, office, mission, task|တာဝန်|noun
任命|にんめい|appointment, nomination, ordination, commission, designation|ခန့်အပ်ခြင်း|noun
抜かす|ぬかす|to omit, to leave out|ချန်လှပ်သည်|verb
抜け出す|ぬけだす|to slip out, to sneak away, to excel|ခိုးထွက်သည်|verb
盗み|ぬすみ|stealing|ခိုးယူခြင်း|noun
沼|ぬま|swamp, bog, pond, lake|ရွှံ့နွံမြေ|noun
音|ね|sound, note|အသံ|noun
値打ち|ねうち|value, worth, price, dignity|တန်ဖိုး|noun
寝かせる|ねかせる|to put to bed, to lay down, to ferment|အိပ်စေသည်|verb
捻子|ねじ|screw, helix, spiral|ဝက်အူ|noun
ねじ回し|ねじまわし|screwdriver|ဝက်အူလှည့်|noun
捻じれる|ねじれる|to twist, to wrench, to screw|လိမ်သည်|verb
鼠|ねず|mouse, rat, dark gray, slate color|ကြွက်|noun
妬む|ねたむ|to be jealous, to be envious|မနာလိုသည်|verb
強請る|ねだる|to tease, to coax, to solicit, to demand|တောင်းဆိုသည်|verb
熱湯|ねっとう|boiling water|ရေဆူပွက်|noun
熱意|ねつい|zeal, enthusiasm|စိတ်အားထက်သန်မှု|noun
熱量|ねつりょう|temperature|အပူချိန်|noun
粘り|ねばり|stickyness, viscosity|ကပ်ငြိမှု|noun
粘る|ねばる|to be sticky, to be adhesive, to persevere, to persist, to stick to|ကပ်သည်၊ စွဲမြဲသည်|verb
値引き|ねびき|price reduction, discount|စျေးလျှော့ခြင်း|noun
根回し|ねまわし|making necessary arrangements|ကြိုတင်စီစဉ်ခြင်း|noun
眠たい|ねむたい|sleepy|အိပ်ငိုက်သော|adjective
練る|ねる|to knead, to work over, to polish up|နယ်သည်|verb
念|ねん|sense, idea, thought, feeling, desire, concern, attention, care|အကြံအစည်|noun
年鑑|ねんかん|yearbook|နှစ်စဉ်စာအုပ်|noun
年号|ねんごう|name of an era, year number|နှစ်အမည်|noun
燃焼|ねんしょう|burning, combustion|လောင်ကျွမ်းခြင်း|noun
年生|ねんせい|pupil in .... year, student in .... year|တန်းသား|noun
年長|ねんちょう|seniority|အကြီးအကဲ|noun
燃料|ねんりょう|fuel|လောင်စာ|noun
年輪|ねんりん|annual tree ring|နှစ်စဉ်အစုံ|noun
脳|のう|brain, memory|ဦးနှောက်|noun
農耕|のうこう|farming, agriculture|လယ်ယာစိုက်ပျိုးခြင်း|noun
農場|のうじょう|farm (agriculture)|လယ်ယာခြံ|noun
農地|のうち|agricultural land|လယ်ယာမြေ|noun
納入|のうにゅう|payment, supply|ပေးဆောင်ခြင်း|noun
逃す|のがす|to let loose, to set free, to let escape|လွတ်စေသည်|verb
逃れる|のがれる|to escape|လွတ်မြောက်သည်|verb
軒並み|のきなみ|row of houses|တန်းစီအိမ်များ|noun
鋸|のこぎり|saw|လွှ|noun
望ましい|のぞましい|desirable, hoped for|လိုချင်ဖွယ်|adjective
臨む|のぞむ|to look out on, to face, to deal with, to attend (function)|ကြည့်ရှုသည်၊ တက်ရောက်သည်|verb
乗っ取る|のっとる|to capture, to occupy, to usurp|သိမ်းပိုက်သည်|verb
長閑|のどか|tranquil, calm, quiet|ငြိမ်းချမ်းသော|adjective
罵る|ののしる|to speak ill of, to abuse|ကဲ့ရဲ့သည်|verb
延べ|のべ|futures, credit (buying), stretching, total|စုစုပေါင်း|noun
飲み込む|のみこむ|to gulp down, to swallow deeply, to understand|မျိုသည်၊ နားလည်သည်|verb
乗り換え|のりかえ|transfer (trains buses etc.)|လဲစီးခြင်း|noun
乗り込む|のりこむ|to board, to embark on, to get into (a car)|စီးတက်သည်|verb
刃|は|edge (of a sword)|ဓါးလက်|noun
派|は|clique, faction, school|ဂိုဏ်း|noun
把握|はあく|grasp, catch, understanding|နားလည်မှု|noun
肺|はい|lung|အဆုတ်|noun
廃棄|はいき|annullment, disposal, abandon, scrap, discarding, repeal|စွန့်ပစ်ခြင်း|noun
配給|はいきゅう|distribution (eg. films rice)|ဖြန့်ဝေခြင်း|noun
配偶者|はいぐうしゃ|spouse, wife, husband|အိမ်ထောင်ဖက်|noun
拝啓|はいけい|Dear (so and so)|ရှင်သန်ချီးမွမ်းခြင်း|noun
背景|はいけい|background, scenery, setting, circumstance|နောက်ခံ|noun
背後|はいご|back, rear|နောက်ကွယ်|noun
灰皿|はいさら|ashtray|ပြာခွက်|noun
廃止|はいし|abolition, repeal|ဖျက်သိမ်းခြင်း|noun
拝借|はいしゃく|borrowing|ငှားယူခြင်း|noun
排除|はいじょ|exclusion, removal, rejection|ဖယ်ထုတ်ခြင်း|noun
排水|はいすい|drainage|ရေထုတ်ခြင်း|noun
敗戦|はいせん|defeat, losing a war|စစ်ရှုံးခြင်း|noun
配置|はいち|arrangement (of resources), disposition|စီစဉ်ခြင်း|noun
配布|はいふ|distribution|ဖြန့်ဝေခြင်း|noun
配分|はいぶん|distribution, allotment|ခွဲဝေခြင်း|noun
配慮|はいりょ|consideration, concern, forethought|စဉ်းစားမှု|noun
配列|はいれつ|arrangement, array (programming)|စီစဉ်ခြင်း|noun
映える|はえる|to shine, to look attractive, to look pretty|တောက်ပသည်|verb
破壊|はかい|destruction|ဖျက်ဆီးခြင်း|noun
墓地|はかち|cemetery, graveyard|သုသာန်|noun
捗る|はかどる|to make progress, to move right ahead (with the work), to advance|တိုးတက်သည်|verb
果ない|はかない|fleeting, transient, short-lived, momentary, vain, fickle, miserable, empty|ခေတ္တ၊ တာရှည်ခံမရသော|adjective
諮る|はかる|to consult with, to confer|တိုင်ပင်သည်|verb
図る|はかる|to plot, to attempt, to plan, to take in, to deceive|စီစဉ်သည်|verb
剥がす|はがす|to tear off, to peel off, to rip off, to strip off|ဆွဲချွတ်သည်|verb
破棄|はき|revocation, annulment, breaking (e.g. treaty)|ဖျက်သိမ်းခြင်း|noun
泊|はく|counter for nights of a stay|ည (ရေတွက်စကား)|counter
迫害|はくがい|persecution|ညှဉ်းပန်းနှိပ်စက်ခြင်း|noun
薄弱|はくじゃく|feebleness, weakness, weak|အားနည်းမှု|noun
白状|はくじょう|confession|ဝန်ချခြင်း|noun
剥ぐ|はぐ|to tear off, to peel off, to rip off, to strip off|အခွံခွာသည်|verb
派遣|はけん|dispatch, send|စေလွှတ်ခြင်း|noun
励ます|はげます|to encourage, to cheer, to raise (the voice)|အားပေးသည်|verb
励む|はげむ|to be zealous, to brace oneself, to endeavour, to strive|အားသွန်ခွန်စိုက်သည်|verb
剥げる|はげる|to come off, to be worn off, to fade, to discolor|ခွာထွက်သည်|verb
鋏|はさみ|scissors|ကတ်ကြေး|noun
柱|はしら|pillar, post|တိုင်|noun
橋渡し|はしわたし|bridge building, mediation|ဖျန်ဖြေရေး|noun
恥|はじ|shame, embarrassment|ရှက်ခြင်း|noun
弾く|はじく|to flip, to snap|ခုန်သည်|verb
始め|はじめ|beginning, start, origin|အစ|noun
始めまして|はじめまして|How do you do?, I am glad to meet you|တွေ့ဆုံရတာဝမ်းသာပါတယ်|phrase
恥じらう|はじらう|to feel shy, to be bashful, to blush|ရှက်သည်|verb
恥じる|はじる|to feel ashamed|ရှက်ကြောက်သည်|verb
蓮|はす|lotus|ကုသုံးပန်း|noun
筈|はず|it should be so|ဖြစ်သင့်သည်|auxiliary
弾む|はずむ|to spring, to bound, to bounce, to be stimulated|ခုန်သည်|verb
破損|はそん|damage|ပျက်စီးခြင်း|noun
機|はた|loom|ရက်ကန်း|noun
果たして|はたして|as was expected, really|မျှော်လင့်ထားသည့်အတိုင်း|adverb
果たす|はたす|to accomplish, to fulfill, to carry out, to achieve|အောင်မြင်သည်|verb
裸足|はだし|barefoot|ခြေဖဝါး|noun
蜂蜜|はちみつ|honey|ပျားရည်|noun
発掘|はっくつ|excavation, exhumation|တူးဖော်ခြင်း|noun
発生|はっせい|outbreak, spring forth, occurrence, incidence, origin|ဖြစ်ပွားခြင်း|noun
発足|はっそく|starting, inauguration|စတင်ခြင်း|noun
初|はつ|first, new|ပထမဦးဆုံး|prefix
発|はつ|departure, beginning, counter for gunshots|ထွက်ခွာခြင်း|noun
発育|はついく|(physical) growth, development|ကြီးထွားမှု|noun
発芽|はつが|burgeoning|အညှောက်ပေါက်ခြင်း|noun
発言|はつげん|utterance, speech, proposal|ပြောဆိုခြင်း|noun
発病|はつびょう|attack (disease)|ရောဂါဖြစ်ခြင်း|noun
初耳|はつみみ|something heard for the first time|ပထမဆုံးကြားသိခြင်း|noun
果て|はて|the end, the extremity, the limit(s), the result|အဆုံး|noun
果てる|はてる|to end, to be finished, to be exhausted, to die, to perish|ကုန်ဆုံးသည်|verb
話し合い|はなしあい|discussion, conference|ဆွေးနွေးခြင်း|noun
甚だ|はなはだ|very, greatly, exceedingly|အလွန်|adverb
華々しい|はなばなしい|brilliant, magnificent, spectacular|တောက်ပသော|adjective
花びら|はなびら|(flower) petal|ပန်းလွှာ|noun
華やか|はなやか|gay, showy, brilliant, gorgeous, florid|တောက်ပသော|adjective
阻む|はばむ|to keep someone from doing, to stop, to prevent, to check, to hinder|ဟန့်တားသည်|verb
浜|はま|beach, seashore|ကမ်းခြေ|noun
浜辺|はまべ|beach, foreshore|ကမ်းခြေ|noun
填まる|はまる|to get into, to go into, to fit, to be fit for|ဝင်သည်|verb
歯磨|はみがき|dentifrice, toothpaste|သွားတိုက်ဆေး|noun
填める|はめる|to get in, to insert, to put on, to make love|ထည့်သည်|verb
生やす|はやす|to grow, to cultivate, to wear beard|စိုက်သည်|verb
早める|はやめる|to hasten, to quicken, to expedite, to precipitate, to accelerate|အရှိန်မြှင့်သည်|verb
流行|はやり|fashionable, fad, in vogue, prevailing|ခေတ်စား|noun
腹立ち|はらだち|anger|ဒေါသ|noun
原っぱ|はらっぱ|open field, empty lot, plain|လွင်ပြင်|noun
張り紙|はりがみ|paper patch, paper backing, poster|ကြေညာစာ|noun
遥か|はるか|far, far-away, distant, remote, far off|အလွန်ဝေးသော|adjective
破裂|はれつ|explosion, rupture, break off|ပေါက်ကွဲခြင်း|noun
腫れる|はれる|to swell (from inflammation), to become swollen|ရောင်သည်|verb
班|はん|group, party, section (mil)|အဖွဲ့|noun
判|はん|seal, stamp, monogram signature, judgment|တံဆိပ်|noun
版|はん|edition|ထုတ်ဝေမှု|noun
繁栄|はんえい|prospering, prosperity, thriving, flourishing|သာယာဝပြောမှု|noun
反感|はんかん|antipathy, revolt, animosity|ဆန့်ကျင်ခြင်း|noun
版画|はんが|art print|ပုံနှိပ်အနုပညာ|noun
反響|はんきょう|echo, reverberation, repercussion, reaction, influence|ပဲ့တင်ထပ်|noun
判決|はんけつ|judicial decision, judgement, sentence, decree|စီရင်ချက်|noun
反撃|はんげき|counterattack, counteroffensive, counterblow|တန်ပြန်တိုက်ခြင်း|noun
反射|はんしゃ|reflection, reverberation|ရောင်ပြန်ဟပ်ခြင်း|noun
繁殖|はんしょく|breed, multiply, increase, propagation|မျိုးပွားခြင်း|noun
繁盛|はんじょう|prosperity, flourishing, thriving|ထွန်းကားခြင်း|noun
反する|はんする|to be inconsistent with, to oppose, to contradict, to transgress, to rebel|ဆန့်ကျင်သည်|verb
判定|はんてい|judgement, decision, award, verdict|စီရင်ဆုံးဖြတ်ချက်|noun
反応|はんのう|reaction, response|တုံ့ပြန်မှု|noun
半端|はんぱ|remnant, fragment, incomplete set, fraction, odd sum, incompleteness|မပြည့်စုံသော|noun
反発|はんぱつ|repelling, rebound, recover, oppose|တွန်းလှန်ခြင်း|noun
反乱|はんらん|insurrection, mutiny, rebellion, revolt, uprising|ပုန်ကန်ခြင်း|noun
氾濫|はんらん|overflowing, flood|လျှံလွှမ်းခြင်း|noun
黴菌|ばいきん|bacteria, germ(s)|ပိုးမွှား|noun
賠償|ばいしょう|reparations, indemnity, compensation|လျော်ကြေးပေးခြင်း|noun
倍率|ばいりつ|diameter, magnification|ချဲ့ချက်|noun
馬鹿馬鹿しい|ばかばかしい|stupid|မိုက်မဲသော|adjective
馬鹿らしい|ばからしい|absurd|အဓိပ္ပာယ်မဲ့သော|adjective
漠然|ばくぜん|obscure, vague, equivocal|မရေရာသော|adjective
爆弾|ばくだん|bomb|ဗုံး|noun
爆破|ばくは|blast, explosion, blow up|ခွဲဖျက်ခြင်း|noun
暴露|ばくろ|disclosure, exposure, revelation|ဖော်ထုတ်ခြင်း|noun
化ける|ばける|to appear in disguise, to take the form of, to change for the worse|အသွင်ပြောင်းသည်|verb
罰|ばち|divine punishment, curse, retribution|အပြစ်ဒဏ်|noun
伐|ばつ|strike, attack, punish|တိုက်ခိုက်ခြင်း|noun
ばてる|ばてる|to be exhausted, to be worn out|ပင်ပန်းနွမ်းနယ်သည်|verb
発条|ばね|spring (e.g. coil leaf)|စပရိန်|noun
散蒔く|ばらまく|to disseminate, to scatter, to give money freely|ဖြန့်ကြဲသည်|verb
判|ばん|size (of paper or books)|အရွယ်အစား|noun
万|ばん|many, all|များစွာ|noun
万人|ばんじん|all people, everybody, 10000 people|လူတိုင်း|noun
万能|ばんのう|all-purpose, almighty, omnipotent|အားလုံးတတ်သော|adjective
番目|ばんめ|cardinal number suffix|စဉ်|suffix
非|ひ|faulty-, non-|မဟုတ်သော|prefix
費|ひ|cost, expense|ကုန်ကျစရိတ်|noun
延いては|ひいては|not only...but also, in addition to, consequently|ထို့အပြင်|conjunction
控室|ひかえしつ|waiting room|စောင့်ဆိုင်းခန်း|noun
控える|ひかえる|to draw in, to hold back, to make notes, to be temperate in|ထိန်းချုပ်သည်|verb
悲観|ひかん|pessimism, disappointment|စိတ်ဓာတ်ကျခြင်း|noun
匹|ひき|head, small animal counter, roll of cloth|ကောင် (ရေတွက်စကား)|counter
引き上げる|ひきあげる|to withdraw, to leave, to pull out, to retire|ရုပ်သိမ်းသည်|verb
率いる|ひきいる|to lead, to spearhead (a group), to command (troops)|ဦးဆောင်သည်|verb
引き受ける|ひきうける|to undertake, to take up, to take over, to be responsible for|တာဝန်ယူသည်|verb
引き起こす|ひきおこす|to cause|ဖြစ်စေသည်|verb
引き下げる|ひきさげる|to pull down, to lower, to reduce, to withdraw|လျှော့ချသည်|verb
引きずる|ひきずる|to seduce, to drag along, to pull, to prolong, to support|ဆွဲသည်|verb
引き取る|ひきとる|to take charge of, to take over, to retire to a private place|လက်ခံသည်|verb
引き分け|ひきわけ|a draw (in competition), tie game|သရေရခြင်း|noun
否決|ひけつ|rejection, negation, voting down|ငြင်းပယ်ခြင်း|noun
非行|ひこう|delinquency, misconduct|အကျင့်ပျက်ခြင်း|noun
日頃|ひごろ|normally, habitually|ပုံမှန်|adverb
久しい|ひさしい|long, long-continued, old (story)|ကြာရှည်သော|adjective
久し振り|ひさしぶり|after a long time|ကြာမြင့်ပြီးနောက်|noun
悲惨|ひさん|misery|အဆင်းရဲဆုံး|adjective
秘書|ひしょ|(private) secretary|အတွင်းရေးမှူး|noun
比重|ひじゅう|specific gravity|အလေးချိန်အချိုး|noun
密か|ひそか|secret, private, surreptitious|လျှို့ဝှက်သော|adjective
浸す|ひたす|to soak, to dip, to drench|စိမ်သည်|verb
一向|ひたすら|earnestly|တစ်သဝေမတိမ်း|adverb
左利き|ひだりきき|left-handedness, sake drinker, left-hander|ဘယ်သန်|noun
引っ掻く|ひっかく|to scratch|ကုတ်သည်|verb
引っ掛ける|ひっかける|to hang (something) on (something), to throw on (clothes), to hook, to catch, to trap|ချိတ်သည်|verb
必修|ひっしゅう|required (subject)|မဖြစ်မနေလေ့လာရမည့်|noun
匹敵|ひってき|comparing with, match, rival, equal|ညီမျှသည်|verb
未|ひつじ|eighth sign of Chinese zodiac (The Ram 1pm-3pm south-southwest June)|ဆိတ်နှစ်|noun
必然|ひつぜん|inevitable, necessary|မလွဲမသွေ|noun
一息|ひといき|puffy, a breath, a pause, an effort|အသက်တစ်ချက်|noun
単|ひとえ|one layer, single|တစ်ထပ်တည်း|noun
人柄|ひとがら|personality, character, personal appearance, gentility|စရိုက်လက္ခဏာ|noun
一頃|ひところ|once, some time ago|တစ်ချိန်က|noun
人質|ひとじち|hostage, prisoner|ဓမ္မ|noun
一筋|ひとすじ|a line, earnestly, blindly, straightforwardly|တစ်ခုတည်း|noun
一まず|ひとまず|for the present, once, in outline|ခဏတာ|adverb
一人でに|ひとりでに|by itself, automatically, naturally|အလိုလိုအလျောက်|adverb
酷い|ひどい|cruel, awful, severe, very bad, serious, terrible, heavy, violent|ဆိုးရွားသော|adjective
日取り|ひどり|fixed date, appointed day|သတ်မှတ်ရက်|noun
雛|ひな|young bird, chick, doll|ကလေးငှက်|noun
日向|ひなた|sunny place, in the sun|နေရောင်ရသောနေရာ|noun
非難|ひなん|blame, attack, criticism|ဝေဖန်ခြင်း|noun
避難|ひなん|taking refuge, finding shelter|ခိုလှုံခြင်း|noun
日の丸|ひのまる|the Japanese flag|ဂျပန်အလံ|noun
火花|ひばな|spark|မီးပွား|noun
日々|ひび|every day, daily, day after day|နေ့စဉ်|noun
悲鳴|ひめい|shriek, scream|အော်ဟစ်သံ|noun
百科事典|ひゃっかじてん|encyclopedia|စွယ်စုံကျမ်း|noun
百科辞典|ひゃっかじてん|encyclopedia|စွယ်စုံကျမ်း|noun
冷やかす|ひやかす|to banter, to make fun of, to jeer at, to cool, to refrigerate|ပြက်ရယ်ပြုသည်|verb
日焼け|ひやけ|sunburn|နေလောင်ခြင်း|noun
票|ひょう|label, ballot, ticket, sign|မဲ|noun
標語|ひょうご|motto, slogan, catchword|ဆောင်ပုဒ်|noun
ひょっと|ひょっと|possibly, accidentally|ဖြစ်နိုင်သည်|adverb
平たい|ひらたい|flat, even, level, simple, plain|ပြားချပ်သော|adjective
比率|ひりつ|ratio, proportion, percentage|အချိုး|noun
肥料|ひりょう|manure, fertilizer|ဓာတ်မြေသြဇာ|noun
比例|ひれい|proportion|အချိုးညီမျှခြင်း|noun
疲労|ひろう|fatigue, weariness|ပင်ပန်းနွမ်းနယ်မှု|noun
広まる|ひろまる|to spread, to be propagated|ပျံ့နှံ့သည်|verb
貧困|ひんこん|poverty, lack|ဆင်းရဲမွဲတေမှု|noun
品質|ひんしつ|quality|အရည်အသွေး|noun
品種|ひんしゅ|brand, kind, description|အမျိုးအစား|noun
貧弱|ひんじゃく|poor, meagre, insubstantial|အားနည်းသော|adjective
頻繁|ひんぱん|frequency|မကြာခဏ|noun
美|び|beauty|အလှ|noun
微笑|びしょう|smile|အပြုံး|noun
美術|びじゅつ|art, fine arts|အနုပညာ|noun
吃驚|びっくり|be surprised, be amazed, be frightened, astonishment|အံ့သြခြင်း|noun
びっしょり|びっしょり|wet through, drenched|စိုစွတ်စွာ|adverb
描写|びょうしゃ|depiction, description, portrayal|ဖော်ပြခြင်း|noun
びり|びり|last on the list, at the bottom|နောက်ဆုံး|noun
微量|びりょう|minuscule amount, extremely small quantity|အနည်းငယ်|noun
敏感|びんかん|sensibility, susceptibility, sensitive (to), well attuned to|ခံစားလွယ်သော|adjective
貧乏|びんぼう|poverty, destitute, poor|ဆင်းရဲသော|adjective
歩|ふ|pawn (in chess or shogi)|ပေ|noun
不意|ふい|sudden, abrupt, unexpected, unforeseen|မမျှော်လင့်သော|adjective
封|ふう|seal|တံဆိပ်ခေါင်း|noun
封鎖|ふうさ|blockade, freezing (funds)|ပိတ်ဆို့ခြင်း|noun
風習|ふうしゅう|custom|ဓလေ့ထုံးတမ်း|noun
風俗|ふうぞく|manners, customs, sex service, sex industry|ဓလေ့ထုံးတမ်း|noun
風土|ふうど|natural features, topography, climate, spiritual features|ရာသီဥတုနှင့်ပထဝီဝင်အခြေအနေ|noun
不可欠|ふかけつ|indispensable, essential|မဖြစ်မနေလိုအပ်သော|adjective
深める|ふかめる|to deepen, to heighten, to intensify|နက်ရှိုင်းစေသည်|verb
不吉|ふきつ|ominous, sinister, bad luck, ill omen, inauspiciousness|မင်္ဂလာမဲ့သော|adjective
不況|ふきょう|recession, depression, slump|စီးပွားရေးကျဆင်းမှု|noun
布巾|ふきん|tea-towel, dish cloth|ပုဝါတို|noun
福|ふく|good fortune|ကံကောင်းခြင်း|noun
復旧|ふくきゅう|restoration, restitution, rehabilitation|ပြန်လည်ထူထောင်ခြင်း|noun
複合|ふくごう|composite, complex|ပေါင်းစပ်ထားသော|noun
福祉|ふくし|welfare, well-being|လူမှုဖူလုံရေး|noun
覆面|ふくめん|mask, veil, disguise|မျက်နှာဖုံး|noun
膨れる|ふくれる|to get cross, to get sulky, to swell (out), to expand|ရောင်သည်|verb
不景気|ふけいき|business recession, hard times, depression, gloom, sullenness|စီးပွားရေးကျဆင်းမှု|noun
老ける|ふける|to age|အိုမင်းသည်|verb
布告|ふこく|edict, ordinance, proclamation|ကြေညာချက်|noun
富豪|ふごう|wealthy person, millionaire|သူဌေး|noun
負債|ふさい|debt, liabilities|အကြွေး|noun
相応しい|ふさわしい|appropriate|သင့်လျော်သော|adjective
不在|ふざい|absence|မရှိခြင်း|noun
不山戯る|ふざける|to romp, to gambol, to frolic, to joke, to make fun of, to flirt|ပြက်ရယ်ပြုသည်|verb
負傷|ふしょう|injury, wound|ဒဏ်ရာရခြင်း|noun
不審|ふしん|incomplete understanding, doubt, question, distrust, suspicion, strangeness|သံသယ|noun
不振|ふしん|dullness, depression, slump, stagnation|အားနည်းမှု|noun
不順|ふじゅん|irregularity, unseasonableness|ပုံမှန်မဟုတ်ခြင်း|noun
付属|ふぞく|attached, belonging, affiliated, annexed, associated, subordinate|တွဲဖက်သော|noun
負担|ふたん|burden, charge, responsibility|တာဝန်၊ ဝန်ထုပ်ဝန်ပိုး|noun
不調|ふちょう|bad condition, not to work out (ie a deal), disagreement|အဆင်မပြေခြင်း|noun
復活|ふっかつ|revival (e.g. musical), restoration|ပြန်လည်ရှင်သန်ခြင်း|noun
復興|ふっこう|revival, renaissance, reconstruction|ပြန်လည်တည်ဆောက်ခြင်း|noun
沸騰|ふっとう|boiling, seething|ရေဆူခြင်း|noun
仏|ふつ|French|ပြင်သစ်|noun
不図|ふと|suddenly, casually, accidentally, incidentally, unexpectedly, unintentionally|ရုတ်တရက်|adverb
不当|ふとう|injustice, impropriety, unreasonableness, undeservedness, unfair, invalid|မမျှတသော|adjective
不動産|ふどうさん|real estate|အိမ်ခြံမြေ|noun
赴任|ふにん|(proceeding to) new appointment|တာဝန်ထမ်းဆောင်ရန်သွားခြင်း|noun
腐敗|ふはい|decay, depravity|ပုပ်သိုးခြင်း၊ အကျင့်ပျက်ခြင်း|noun
不評|ふひょう|bad reputation, disgrace, unpopularity|အသရေပျက်ခြင်း|noun
不便|ふびん|pity, compassion|စာနာမှု|noun
不服|ふふく|dissatisfaction, discontent, disapproval, objection, complaint, protest, disagreement|မကျေနပ်ခြင်း|noun
普遍|ふへん|universality, ubiquity, omnipresence|အနှံ့အပြားရှိခြင်း|noun
踏まえる|ふまえる|to be based on, to have origin in|အခြေခံသည်|verb
文|ふみ|letter, writings|စာ|noun
不明|ふめい|unknown, obscure, indistinct, uncertain, ambiguous, ignorant|မသိရသော|adjective
扶養|ふよう|support, maintenance|ထောက်ပံ့ကျွေးမွေးခြင်း|noun
振り|ふり|pretence, show, appearance|ဟန်ဆောင်ခြင်း|noun
振り出し|ふりだし|outset, starting point, drawing or issuing (draft)|အစ|noun
不良|ふりょう|badness, delinquent, inferiority, failure|မကောင်းသော|adjective
浮力|ふりょく|buoyancy, floating power|မျောပါအား|noun
震わせる|ふるわせる|to be shaking, to be trembling|တုန်လှုပ်စေသည်|verb
付録|ふろく|appendix, supplement|နောက်ဆက်တွဲ|noun
分|ふん|minute|မိနစ်|noun
憤慨|ふんがい|indignation, resentment|ဒေါသထွက်ခြင်း|noun
紛失|ふんしつ|losing something|ပျောက်ဆုံးခြင်း|noun
噴出|ふんしゅつ|spewing, gushing, spouting, eruption, effusion|ထွက်လာခြင်း|noun
紛争|ふんそう|dispute, trouble, strife|အငြင်းပွားမှု|noun
ふんだん|ふんだん|plentiful, abundant, lavish|များပြားသော|adjective
奮闘|ふんとう|hard struggle, strenuous effort|ကြိုးပမ်းအားထုတ်မှု|noun
粉末|ふんまつ|fine powder|အမှုန့်|noun
部|ぶ|department, part, category, counter for copies of a newspaper or magazine|ဌာန|noun
部下|ぶか|subordinate person|လက်အောက်ငယ်သား|noun
ぶかぶか|ぶかぶか|too big, baggy|ကျယ်လွန်းသော|adjective
侮辱|ぶじょく|insult, contempt, slight|စော်ကားခြင်း|noun
武装|ぶそう|arms, armament, armed|လက်နက်ကိုင်ခြင်း|noun
斑|ぶち|spots, speckles, mottles|အစက်အပြောက်|noun
物資|ぶっし|goods, materials|ပစ္စည်းများ|noun
物体|ぶったい|body, object|အရာဝတ္ထု|noun
物議|ぶつぎ|public discussion (criticism)|လူထုဆွေးနွေးငြင်းခုံမှု|noun
打付ける|ぶつける|to knock, to run into, to nail on, to strike hard, to hit and attack|ပုတ်သည်|verb
仏像|ぶつぞう|Buddhist image (statue)|ဗုဒ္ဓရုပ်|noun
無難|ぶなん|safety, security|ဘေးကင်းခြင်း|noun
部門|ぶもん|class, group, category, department, field, branch|ဌာနခွဲ|noun
ぶら下げる|ぶらさげる|to hang, to suspend, to dangle, to swing|ချိတ်ဆွဲသည်|verb
ぶらぶら|ぶらぶら|dangle heavily, swing, sway to and fro, aimlessly, idly|လှည့်လည်သည်|adverb
武力|ぶりょく|armed might, military power, the sword, force|လက်နက်အင်အား|noun
無礼|ぶれい|impolite, rude|ယဉ်ကျေးမှုမရှိသော|adjective
文化財|ぶんかざい|cultural assets, cultural property|ယဉ်ကျေးမှုအမွေအနှစ်|noun
分業|ぶんぎょう|division of labor, specialization, assembly-line production|အလုပ်ခွဲဝေခြင်း|noun
文語|ぶんご|written language, literary language|စာပေဘာသာစကား|noun
分散|ぶんさん|dispersion, decentralization, variance (statistics)|ကွဲလွင့်ခြင်း|noun
分子|ぶんし|numerator, molecule|မော်လီကျူး|noun
文書|ぶんしょ|document, writing, letter, note, records, archives|စာရွက်စာတမ်း|noun
分担|ぶんたん|apportionment, sharing|ခွဲဝေခြင်း|noun
分配|ぶんぱい|division, sharing|ခွဲဝေခြင်း|noun
分母|ぶんぼ|denominator|ပိုင်းခြေ|noun
分離|ぶんり|separation, detachment, segregation, isolation|ခွဲခြားခြင်း|noun
分裂|ぶんれつ|split, division, break up|ကွဲပြားခြင်း|noun
兵器|へいき|arms, weapons, ordinance|လက်နက်|noun
閉口|へいこう|shut mouth|ပါးစပ်ပိတ်ခြင်း|noun
平行|へいこう|(going) side by side, concurrent, abreast, at the same time, occurring together, parallel|အပြိုင်|noun
閉鎖|へいさ|closing, closure, shutdown, lockout, unsociable|ပိတ်သိမ်းခြင်း|noun
兵士|へいし|soldier|စစ်သား|noun
平常|へいじょう|normal, usual|ပုံမှန်|noun
平方|へいほう|square (e.g. metre), square|နှစ်ထပ်ကိန်း|noun
並列|へいれつ|arrangement, parallel, abreast|တန်းတူစီစဉ်ခြင်း|noun
辟易|へきえき|wince, shrink back, succumbing to, being frightened, disconcerted|ကြောက်ရွံ့ခြင်း|noun
臍|へそ|navel, belly-button|ချက်|noun
隔たる|へだたる|to be distant|ကွာဝေးသည်|verb
謙る|へりくだる|to deprecate oneself and praise the listener|နှိမ့်ချသည်|verb
経る|へる|to pass, to elapse, to experience|ဖြတ်သန်းသည်|verb
編|へん|compilation, editing, completed poem, book, part of book|အပိုင်း|noun
偏|へん|side, left radical of a character, inclining, inclining toward, biased|တစ်ဖက်သို့|noun
変革|へんかく|change, reform, revolution, upheaval, (the) Reformation|ပြောင်းလဲမှု|noun
返還|へんかん|return, restoration|ပြန်လည်ပေးအပ်ခြင်း|noun
偏見|へんけん|prejudice, narrow view|မှားယွင်းသောအမြင်|noun
返済|へんさい|repayment|ပြန်ဆပ်ခြင်း|noun
変遷|へんせん|change, transition, vicissitudes|ပြောင်းလဲမှု|noun
返答|へんとう|reply|ပြန်ကြားချက်|noun
変動|へんどう|change, fluctuation|အပြောင်းအလဲ|noun
弁解|べんかい|excuse, explanation|ဆင်ခြေ, ရှင်းလင်းချက်|noun
便宜|べんぎ|convenience, advantage|အဆင်ပြေမှု, အကျိုးကျေးဇူး|noun
弁護|べんご|defense, advocacy|ခုခံကာကွယ်ခြင်း, ရှေ့နေလိုက်ခြင်း|noun
弁償|べんしょう|compensation, reimbursement|လျော်ကြေး, ပြန်အမ်းငွေ|noun
弁論|べんろん|debate, argument|စကားစစ်ထိုးခြင်း, အငြင်းအခုံ|noun
ぺこぺこ|ぺこぺこ|fawningly, very hungry|굽신굽신, ဗိုက်ဆာလွန်းသော|adverb
穂|ほ|ear/head (of a plant)|အနှံ (အပင်၏)|noun
保育|ほいく|childcare, nurturing|ကလေးပြုစုစောင့်ရှောက်ခြင်း, ပြုစုပျိုးထောင်ခြင်း|noun
倣|ほう|imitation, emulation|အတုခိုးခြင်း, အားကျခြင်း|noun
法案|ほうあん|bill (legislative)|ဥပဒေကြမ်း|noun
崩壊|ほうかい|collapse, decay|ပြိုကျခြင်း, ယိုယွင်းခြင်း|noun
法学|ほうがく|law, jurisprudence|ဥပဒေပညာ|noun
放棄|ほうき|abandonment, renunciation|စွန့်လွှတ်ခြင်း, ဖယ်ရှားခြင်း|noun
宝器|ほうき|treasured article, treasure|တန်ဖိုးကြီးပစ္စည်း, ရတနာ|noun
封建|ほうけん|feudal|မြေရှင်ပဒေသရာဇ်စနစ်|adjective
豊作|ほうさく|abundant harvest, bumper crop|သီးနှံအထွက်ကောင်းခြင်း, စပါးရိတ်သိမ်းမှုကောင်းခြင်း|noun
方策|ほうさく|plan, policy|အစီအစဉ်, မူဝါဒ|noun
奉仕|ほうし|service, attendance|ဝန်ဆောင်မှု, အမှုတော်ထမ်းခြင်း|noun
方式|ほうしき|form, method, system|ပုံစံ, နည်းလမ်း, စနစ်|noun
放射|ほうしゃ|radiation, emission|ဓာတ်ရောင်ခြည်, ထုတ်လွှတ်ခြင်း|noun
放射能|ほうしゃのう|radioactivity|ရေဒီယိုသတ္တိကြွမှု|noun
報酬|ほうしゅう|reward, remuneration|ဆုလာဘ်, အခကြေးငွေ|noun
放出|ほうしゅつ|release, emission|ထုတ်လွှတ်ခြင်း|noun
報じる|ほうじる|to inform, to report|သတင်းပို့သည်, အကြောင်းကြားသည်|verb
報ずる|ほうずる|to inform, to report|သတင်းပို့သည်, အကြောင်းကြားသည်|verb
放置|ほうち|neglect, leaving as is|ပစ်ထားခြင်း, လျစ်လျူရှုခြင်း|noun
法廷|ほうてい|courtroom|တရားရုံးခန်း|noun
報道|ほうどう|news report, press coverage|သတင်း, သတင်းထုတ်ပြန်ချက်|noun
褒美|ほうび|reward, prize|ဆု, ဆုလာဘ်|noun
葬る|ほうむる|to bury, to entomb|မြှုပ်နှံသည်, သင်္ဂြိုဟ်သည်|verb
放り込む|ほうりこむ|to throw into|ပစ်ထည့်သည်|verb
放り出す|ほうりだす|to throw out, to abandon|ပစ်ထုတ်သည်, စွန့်ပစ်သည်|verb
飽和|ほうわ|saturation|ပြည့်ဝမှု|noun
保温|ほおん|retaining warmth, insulation|အပူထိန်းခြင်း|noun
捕獲|ほかく|capture, seizure|ဖမ်းဆီးခြင်း|noun
保管|ほかん|storage, safekeeping|သိုလှောင်ခြင်း, ထိန်းသိမ်းစောင့်ရှောက်ခြင်း|noun
補給|ほきゅう|supply, replenishment|ထောက်ပံ့ခြင်း, ဖြည့်တင်းခြင်း|noun
補強|ほきょう|reinforcement, strengthening|အားဖြည့်ခြင်း, ခိုင်ခံ့စေခြင်း|noun
保険|ほけん|insurance|အာမခံ|noun
捕鯨|ほげい|whaling|ဝေလငါးဖမ်းခြင်း|noun
誇る|ほこる|to be proud of, to boast|ဂုဏ်ယူသည်, ကြွားဝါသည်|verb
綻びる|ほころびる|to come apart, to begin to open|ချုပ်ရိုးပြေသည်, စတင်ပွင့်သည်|verb
保護|ほご|protection, care|ကာကွယ်စောင့်ရှောက်ခြင်း, ပြုစုစောင့်ရှောက်ခြင်း|noun
乾|ほし|dried thing|အခြောက်လှန်းထားသောအရာ|noun
干し物|ほしもの|dried laundry|အခြောက်လှန်းထားသောအဝတ်|noun
保守|ほしゅ|conservative|ရှေးရိုးစွဲ|noun
保障|ほしょう|guarantee, security|အာမခံချက်, လုံခြုံရေး|noun
補償|ほしょう|compensation, reparation|လျော်ကြေး|noun
補充|ほじゅう|replenishment, supplement|ဖြည့်စွက်ခြင်း, အားဖြည့်ခြင်း|noun
補助|ほじょ|assistance, aid|အကူအညီ, အထောက်အပံ့|noun
舗装|ほそう|pavement, surfacing|လမ်းခင်းခြင်း|noun
補足|ほそく|supplement, complement|ဖြည့်စွက်ချက်|noun
発作|ほっさ|fit, seizure, spasm|တက်ခြင်း, အကြောဆွဲခြင်း|noun
ほっと|ほっと|with a sense of relief|သက်ပြင်းချကာ|adverb
頬っぺた|ほっぺた|cheek|ပါး|noun
辺り|ほとり|vicinity, neighborhood|အနီးအနား, ပတ်ဝန်းကျင်|noun
殆ど|ほとんど|almost, mostly|နီးပါး, အများအားဖြင့်|adverb
解く|ほどく|to untie, to unfasten|ဖြေသည်, ဖြည်သည်|verb
施す|ほどこす|to give, to apply, to perform|ပေးကမ်းသည်, အသုံးပြုသည်, လုပ်ဆောင်သည်|verb
保母|ほぼ|nursery school teacher|မူကြိုဆရာမ|noun
保養|ほよう|health preservation, recreation|ကျန်းမာရေးထိန်းသိမ်းခြင်း, အပန်းဖြေခြင်း|noun
捕吏|ほり|constable, police officer|ရဲအရာရှိ|noun
捕虜|ほりょ|prisoner of war|စစ်သုံ့ပန်း|noun
滅びる|ほろびる|to be ruined, to perish|ပျက်စီးသည်, ပျောက်ကွယ်သည်|verb
滅ぼす|ほろぼす|to destroy, to ruin|ဖျက်ဆီးသည်, ပျက်စီးစေသည်|verb
本格|ほんかく|authentic, genuine|စစ်မှန်သော, တကယ့်|noun
本館|ほんかん|main building|အဓိကအဆောက်အအုံ|noun
本気|ほんき|seriousness, earnestness|အလေးအနက်, အတည်|noun
本質|ほんしつ|essence, true nature|အနှစ်သာရ, မူလသဘာဝ|noun
本体|ほんたい|substance, main body, real form|အရာဝတ္ထု, ပင်မကိုယ်ထည်, ပုံစံအမှန်|noun
本音|ほんね|real intention, true feelings|ရည်ရွယ်ချက်အမှန်, စိတ်ရင်းအမှန်|noun
本の|ほんの|mere, just|သာမန်, ဒီအတိုင်း|adjective
本能|ほんのう|instinct|ဗီဇစိတ်|noun
本場|ほんば|home, the best place for|ဇာတိမြေ, အကောင်းဆုံးနေရာ|noun
本文|ほんぶん|text, main body|စာသား, ပင်မစာကိုယ်|noun
本名|ほんみょう|real name|အမည်ရင်း|noun
卯|ぼう|the Hare (4th zodiac sign)|ယုန် (ရာသီခွင်)|noun
防衛|ぼうえい|defense, protection|ကာကွယ်ရေး, အကာအကွယ်|noun
防火|ぼうか|fire prevention|မီးဘေးကာကွယ်ရေး|noun
妨害|ぼうがい|obstruction, interference|အနှောင့်အယှက်, နှောင့်ယှက်ခြင်း|noun
紡績|ぼうせき|spinning (textiles)|ချည်ငင်ခြင်း|noun
呆然|ぼうぜん|dumbfounded, aghast|ကြက်သေသေ, အံ့ဩတကြီး|adverb
膨脹|ぼうちょう|expansion, swelling|ကျယ်ပြန့်ခြင်း, ဖောင်းပွခြင်း|noun
冒頭|ぼうとう|beginning, opening|အစ, အဖွင့်|noun
暴動|ぼうどう|riot, uprising|အဓိကရုဏ်း, ဆူပူအုံကြွမှု|noun
暴風|ぼうふう|storm, gale|မုန်တိုင်း, လေပြင်း|noun
暴力|ぼうりょく|violence|အကြမ်းဖက်မှု|noun
募金|ぼきん|fundraising|ရန်ပုံငွေကောက်ခံခြင်း|noun
牧師|ぼくし|pastor, minister|သင်းအုပ်ဆရာ|noun
母校|ぼこう|alma mater|မိခင်ကျောင်း|noun
没収|ぼっしゅう|forfeiture, confiscation|သိမ်းဆည်းခြင်း, ရာဇဝတ်သင့်ပစ္စည်းအဖြစ်သိမ်းခြင်း|noun
坊ちゃん|ぼっちゃん|son (respectful), young master|သူတစ်ပါး၏သား, သခင်လေး|noun
ぼつぼつ|ぼつぼつ|gradually, bit by bit|တဖြည်းဖြည်း, တစ်စတစ်စ|adverb
没落|ぼつらく|ruin, downfall|ပျက်စီးခြင်း, ကျဆုံးခြင်း|noun
ぼやく|ぼやく|to grumble, to complain|မြည်တွန်တောက်တီးသည်, မကျေမနပ်ပြောသည်|verb
ぼやける|ぼやける|to become dim, to become blurred|ဝါးသည်, မชัดเจนဖြစ်လာသည်|verb
藍褸|ぼろ|rag, tattered clothes, flaw|အစုတ်, စုတ်ပြဲနေသောအဝတ်, အပြစ်အနာအဆာ|noun
枚|まい|counter for flat objects|ပြားချပ်သောအရာများအတွက်ရေတွက်ပုံ|noun
埋蔵|まいぞう|buried property, treasure|မြှုပ်နှံထားသောပစ္စည်း, ရတနာ|noun
舞う|まう|to dance, to flutter|ကသည်, လှုပ်ခတ်သည်|verb
真上|まうえ|right above, directly overhead|တည့်တည့်အပေါ်|noun
前売り|まえうり|advance sale, booking|ကြိုတင်ရောင်းချခြင်း, ကြိုတင်မှာယူခြင်း|noun
前置き|まえおき|preface, introduction|အမှာစာ, နိဒါန်း|noun
前もって|まえもって|in advance, beforehand|ကြိုတင်၍|adverb
任す|まかす|to entrust, to leave to|အပ်နှံသည်, လွှဲအပ်သည်|verb
負かす|まかす|to defeat|အနိုင်ယူသည်|verb
賄う|まかなう|to provide (meals), to cover (costs)|ထောက်ပံ့သည်, ကျခံသည်|verb
曲がる|まがる|to turn, to bend|ကွေ့သည်, ကွေးသည်|verb
巻|まき|volume, roll|အတွဲ, လိပ်|noun
紛らわしい|まぎらわしい|confusing, ambiguous|ရှုပ်ထွေးစေသော, မရှင်းလင်းသော|adjective
紛れる|まぎれる|to be diverted, to be lost in|သတိလွှဲသွားသည်, ရောနှောသွားသည်|verb
膜|まく|membrane, film|အမြှေးပါး, ဖလင်|noun
捲る|まくる|to roll up, to do ... furiously|လိပ်တင်သည်, ပြင်းပြင်းထန်ထန်လုပ်သည်|verb
真心|まこころ|sincerity, devotion|စိတ်ရင်းမှန်, သစ္စာစောင့်သိမှု|noun
誠|まこと|sincerity, truth|ရိုးသားမှု, အမှန်တရား|noun
真に|まことに|truly, indeed|အမှန်စင်စစ်, တကယ်တော့|adverb
まごつく|まごつく|to be confused, to be flustered|ရှုပ်ထွေးသွားသည်, ကမောက်ကမဖြစ်သည်|verb
正しく|まさしく|surely, certainly|ဧကန်မလွဲ, သေချာပေါက်|adverb
正に|まさに|just, exactly, surely|တိတိကျကျ, သေချာပေါက်|adverb
勝る|まさる|to surpass, to excel|သာလွန်သည်, ထူးချွန်သည်|verb
増し|まし|better, preferable|ပိုကောင်းသော, ပိုမိုနှစ်သက်ဖွယ်|adjective
真下|ました|right under, directly below|တည့်တည့်အောက်|noun
況して|まして|still more, to say nothing of|ပို၍ပင်, ... ဆိုဖွယ်မရှိ|adverb
交える|まじえる|to mix, to exchange (words)|ရောနှောသည်, ဖလှယ်သည်|verb
交わる|まじわる|to cross, to associate with|ဖြတ်သည်, ပေါင်းသင်းသည်|verb
麻酔|ますい|anesthesia|မေ့ဆေး|noun
益々|ますます|increasingly, more and more|တိုး၍တိုး၍, ပို၍ပို၍|adverb
不味い|まずい|unappetizing, awkward, bad (situation)|အရသာမရှိသော, အဆင်မပြေသော, ဆိုးသော|adjective
股|また|groin, thigh|ပေါင်ခြံ, ပေါင်|noun
跨がる|またがる|to straddle, to extend over|ခွသည်, ကျယ်ပြန့်သည်|verb
跨ぐ|またぐ|to step over, to straddle|ကျော်ခွသည်|verb
瞬き|またたき|twinkling, blink|မှိတ်တုတ်မှိတ်တုတ်, မျက်တောင်ခတ်ခြင်း|noun
待ち合わせ|まちあわせ|appointment, meeting|ချိန်းဆိုမှု, တွေ့ဆုံမှု|noun
間違う|まちがう|to make a mistake, to be wrong|မှားသည်, မှားယွင်းသည်|verb
待ち遠しい|まちどおしい|to look forward to, can't wait|မျှော်လင့်နေသော, မစောင့်နိုင်လောက်အောင်|adjective
待ち望む|まちのぞむ|to wait eagerly for|စိတ်အားထက်သန်စွာစောင့်သည်|verb
区々|まちまち|various, diverse|အမျိုးမျိုး, ကွဲပြားသော|adjective
末期|まっき|last stage, final period|နောက်ဆုံးအဆင့်, နောက်ဆုံးကာလ|noun
真っ二つ|まったつ|in two, in half|နှစ်ပိုင်း, တစ်ဝက်|noun
的|まと|target, mark|ပစ်မှတ်, လက္ခဏာ|noun
纏まり|まとまり|unity, conclusion, consistency|စည်းလုံးညီညွတ်မှု, အဆုံးသတ်, တည်ငြိမ်မှု|noun
纏め|まとめ|summary, conclusion|အကျဉ်းချုပ်, အဆုံးသတ်|noun
免れる|まぬかれる|to escape from, to be exempted|လွတ်မြောက်သည်, ကင်းလွတ်ခွင့်ရသည်|verb
招き|まねき|invitation|ဖိတ်ကြားခြင်း|noun
麻痺|まひ|paralysis, numbness|လေဖြတ်ခြင်း, ထုံကျင်ခြင်း|noun
眩しい|まぶしい|dazzling, radiant|မျက်စိကျိန်းသော, တောက်ပသော|adjective
目蓋|まぶた|eyelid|မျက်ခွံ|noun
間々|まま|occasionally, sometimes|ရံဖန်ရံခါ, တစ်ခါတစ်ရံ|adverb
間もなく|まもなく|soon, before long|မကြာမီ, မကြာခင်|adverb
眉|まゆ|eyebrow|မျက်ခုံး|noun
鞠|まり|ball (traditional)|ဘောလုံး (ရိုးရာ)|noun
丸ごと|まるごと|whole, in its entirety|တစ်ခုလုံး, အကုန်လုံး|adverb
丸っきり|まるっきり|completely, utterly|လုံးဝ, အစအဆုံး|adverb
丸で|まるで|just as if, completely|... ကဲ့သို့ပင်, လုံးဝ|adverb
丸々|まるまる|completely, plump|လုံးဝ, ဖောင်းဖောင်း|adverb
丸める|まるめる|to make round, to roll up|လုံးသည်, လိပ်သည်|verb
満月|まんげつ|full moon|လပြည့်နေ့|noun
満場|まんじょう|unanimous, the whole hall|တညီတညွတ်တည်း, ပရိသတ်အပြည့်|noun
真ん中|まんなか|middle, center|အလယ်, ဗဟို|noun
真ん前|まんまえ|right in front|တည့်တည့်ရှေ့|noun
真ん丸い|まんまるい|perfectly round|လုံးဝန်းသော|adjective
三|み|three|သုံး|noun
見合い|みあい|formal marriage interview|အိမ်ထောင်ဖက်ရွေးရန်တရားဝင်တွေ့ဆုံခြင်း|noun
見合わせる|みあわせる|to exchange glances, to postpone|အကြည့်ချင်းဖလှယ်သည်, ရွှေ့ဆိုင်းသည်|verb
見落とす|みおとす|to overlook, to fail to notice|သတိမမူမိ, မမြင်လိုက်|verb
未開|みかい|uncivilized, primitive|ယဉ်ကျေးမှုမထွန်းကားသေးသော, ရှေးကျသော|noun
味覚|みかく|taste, palate, sense of taste|အရသာ, အရသာခံအာရုံ|noun
見掛ける|みかける|to (happen to) see, to notice|တွေ့မြင်သည်, သတိပြုမိသည်|verb
三日月|みかずき|crescent moon|လခြမ်း|noun
見方|みかた|viewpoint|အမြင်, ရှုထောင့်|noun
見苦しい|みぐるしい|unsightly, ugly|အရုပ်ဆိုးသော, ကြည့်ရဆိုးသော|adjective
見込み|みこみ|hope, prospects, expectation|မျှော်လင့်ချက်, အလားအလာ|noun
未婚|みこん|unmarried|အိမ်ထောင်မရှိ|noun
惨め|みじめ|miserable|သနားစရာကောင်းသော|adjective
未熟|みじゅく|inexperienced, immature|အတွေ့အကြုံမရှိသော, မရင့်ကျက်သော|adjective
微塵|みじん|particle, atom|အမှုန်, အဏုမြူ|noun
見すぼらしい|みすぼらしい|shabby, seedy|စုတ်စုတ်ပြတ်ပြတ်, နွမ်းပါးသော|adjective
見せびらかす|みせびらかす|to show off, to flaunt|ကြွားဝါသည်, ပေါ်လုံးထုတ်သည်|verb
見せ物|みせもの|show, exhibition|ပြပွဲ, ပွဲလမ်းသဘင်|noun
満たす|みたす|to satisfy, to fill, to fulfill|ကျေနပ်စေသည်, ဖြည့်ဆည်းသည်|verb
乱す|みだす|to throw out of order, to disturb|ဖရိုဖရဲဖြစ်စေသည်, နှောင့်ယှက်သည်|verb
乱れる|みだれる|to be disordered, to be disturbed|ဖရိုဖရဲဖြစ်သည်, စိတ်ရှုပ်သည်|verb
未知|みち|unknown|မသိသေးသော|noun
導く|みちびく|to guide, to lead|လမ်းညွှန်သည်, ဦးဆောင်သည်|verb
身近|みぢか|familiar, close to one|ရင်းနှီးသော, မိမိနှင့်နီးစပ်သော|adjective
密集|みっしゅう|crowd, dense formation|လူအုပ်, ထူထပ်သော|noun
密接|みっせつ|close, intimate, related|ရင်းနှီးသော, ဆက်စပ်သော|adjective
見っともない|みっともない|shameful, indecent|ရှက်ဖွယ်ကောင်းသော, မဖွယ်မရာ|adjective
蜜|みつ|nectar, honey|ဝတ်ရည်, ပျားရည်|noun
密度|みつど|density|သိပ်သည်းဆ|noun
見積り|みつもり|estimation, quotation|ခန့်မှန်းခြေ, ဈေးနှုန်းတင်ပြချက်|noun
未定|みてい|undecided, pending|မဆုံးဖြတ်ရသေးသော, ဆိုင်းငံ့ထားသော|noun
見通し|みとおし|perspective, outlook, forecast|အမြင်, အလားအလာ, ခန့်မှန်းချက်|noun
源|みなもと|source, origin|အရင်းအမြစ်, ဇာစ်မြစ်|noun
身なり|みなり|personal appearance|ကိုယ်နေဟန်ထား, ဝတ်စားဆင်ယင်မှု|noun
峰|みね|peak, ridge|တောင်ထွတ်, တောင်စွယ်|noun
見逃す|みのがす|to miss, to overlook, to let escape|လွတ်သွားသည်, သတိမမူမိ, လွှတ်ပေးသည်|verb
見晴らし|みはらし|view|ရှုခင်း|noun
身振り|みぶり|gesture|ကိုယ်ဟန်အမူအရာ|noun
見舞|みまい|enquiry, visit to a sick person|သတင်းမေးခြင်း, လူမမာသတင်းမေးသွားခြင်း|noun
脈|みゃく|pulse|သွေးခုန်နှုန်း|noun
未練|みれん|lingering affection, regret|စွဲလန်းမှု, နောင်တ|noun
見渡す|みわたす|to look out over, to survey|လှမ်းကြည့်သည်, ခြုံငုံကြည့်သည်|verb
民主|みんしゅ|democratic|ဒီမိုကရက်တစ်|noun
民宿|みんしゅく|private home providing lodging|တည်းခိုခန်း (ကိုယ်ပိုင်အိမ်)|noun
民族|みんぞく|people, race, nation|လူမျိုး, တိုင်းရင်းသား|noun
民俗|みんぞく|folk customs|ရိုးရာဓလေ့|noun
六|む|six|ခြောက်|noun
無意味|むいみ|nonsense, no meaning|အဓိပ္ပာယ်မရှိသော|adjective
向き|むき|direction, suitability|ဦးတည်ရာ, သင့်တော်မှု|noun
無口|むくち|reticent, quiet|စကားနည်းသော, တိတ်ဆိတ်သော|adjective
向け|むけ|for, intended for|အတွက်, ရည်ရွယ်သည့်|noun
婿|むこ|son-in-law|သမက်|noun
無効|むこう|invalid, no effect|အကျိုးသက်ရောက်မှုမရှိသော, ပျက်ပြယ်သော|adjective
無言|むごん|silence|တိတ်ဆိတ်ခြင်း|noun
毟る|むしる|to pluck, to pick, to tear|နုတ်သည်, ဆွဲဖြုတ်သည်|verb
無邪気|むじゃき|innocence, simple-mindedness|အပြစ်ကင်းစင်ခြင်း, ရိုးသားခြင်း|adjective
結び|むすび|ending, conclusion, union|အဆုံးသတ်, နိဂုံး, ပေါင်းစည်းမှု|noun
結び付き|むすびつき|connection, relation|ဆက်သွယ်မှု, ဆက်ဆံရေး|noun
結び付く|むすびつく|to be connected, to join|ဆက်စပ်သည်, ပေါင်းစည်းသည်|verb
結び付ける|むすびつける|to combine, to join, to tie|ပေါင်းစပ်သည်, ဆက်သွယ်သည်, ချည်သည်|verb
無線|むせん|wireless, radio|ကြိုးမဲ့, ရေဒီယို|noun
無駄遣い|むだづかい|wasteful spending, squandering|ဖြုန်းတီးခြင်း, ငွေဖြုန်းခြင်း|noun
無断|むだん|without permission, without notice|ခွင့်ပြုချက်မရှိဘဲ, အသိမပေးဘဲ|noun
無知|むち|ignorance|အသိပညာမဲ့ခြင်း|noun
無茶|むちゃ|absurd, unreasonable, reckless|အဓိပ္ပာယ်မရှိသော, မဆင်မခြင်|adjective
無茶苦茶|むちゃくちゃ|confused, messed up, unreasonable|ရှုပ်ထွေးနေသော, ပျက်စီးနေသော, အဓိပ္ပာယ်မရှိသော|adjective
空しい|むなしい|vacant, futile, empty|အချည်းနှီး, အကျိုးမရှိသော, ဗလာ|adjective
無念|むねん|chagrin, regret|နောင်တ, ဝမ်းနည်းခြင်း|noun
無能|むのう|incompetence|အရည်အချင်းမရှိခြင်း|noun
無闇に|むやみに|unreasonably, recklessly, at random|မဆင်မခြင်, လက်လွတ်စပယ်, ကျပန်း|adverb
無用|むよう|useless, unnecessary|အသုံးမဝင်သော, မလိုအပ်သော|adjective
群がる|むらがる|to swarm, to gather|အုံသည်, စုရုံးသည်|verb
無論|むろん|of course, naturally|ဟုတ်ပါတယ်, သဘာဝကျပါတယ်|adverb
名産|めいさん|noted product, specialty|နာမည်ကြီးထုတ်ကုန်, အထူးထုတ်ကုန်|noun
名称|めいしょう|name, title|အမည်, ခေါင်းစဉ်|noun
命中|めいちゅう|a hit (target)|ထိမှန်ခြင်း (ပစ်မှတ်)|noun
名簿|めいぼ|register of names, list|အမည်စာရင်း|noun
名誉|めいよ|honor, credit, prestige|ဂုဏ်, ဂုဏ်သိက္ခာ|noun
明瞭|めいりょう|clarity|ရှင်းလင်းပြတ်သားမှု|adjective
明朗|めいろう|bright, cheerful|တောက်ပသော, ပျော်ရွှင်သော|adjective
目方|めかた|weight|အလေးချိန်|noun
恵み|めぐみ|blessing, grace|ကောင်းချီး, ကျေးဇူးတော်|noun
恵む|めぐむ|to bless, to show mercy to|ကောင်းချီးပေးသည်, ကရုဏာပြသည်|verb
目覚しい|めざましい|brilliant, splendid, remarkable|ထူးချွန်သော, ခမ်းနားသော, မှတ်သားလောက်သော|adjective
目覚める|めざめる|to wake up|နိုးသည်|verb
召す|めす|to call, to wear, to eat (honorific)|ခေါ်သည်, ဝတ်ဆင်သည်, သုံးဆောင်သည် (ရိုသေ) |verb
雌|めす|female (animal)|အမ (တိရစ္ဆာန်)|noun
滅茶苦茶|めちゃくちゃ|absurd, unreasonable, messed up|အဓိပ္ပာယ်မရှိသော, မဆင်မခြင်, ရှုပ်ပွနေသော|adjective
目付き|めつき|look, expression of the eyes|အကြည့်, မျက်လုံးအမူအရာ|noun
滅亡|めつぼう|downfall, ruin, destruction|ကျဆုံးခြင်း, ပျက်စီးခြင်း|noun
愛でたい|めでたい|auspicious, happy|မင်္ဂလာရှိသော, ပျော်ရွှင်သော|adjective
目眩|めまい|dizziness, giddiness|မူးဝေခြင်း|noun
目盛|めもり|scale, gradations|အတိုင်းအတာ, အမှတ်အသား|noun
面会|めんかい|interview, meeting with someone|တွေ့ဆုံမေးမြန်းခြင်း, တွေ့ဆုံခြင်း|noun
免除|めんじょ|exemption, exoneration|ကင်းလွတ်ခွင့်, လွတ်ငြိမ်းခွင့်|noun
面する|めんする|to face on, to look out on|မျက်နှာမူသည်, မျက်နှာချင်းဆိုင်သည်|verb
面目|めんぼく|face, honor, reputation|မျက်နှာ, ဂုဏ်သိက္ခာ|noun
設ける|もうける|to create, to establish|ဖန်တီးသည်, တည်ထောင်သည်|verb
申し入れる|もうしいれる|to propose, to suggest|အဆိုပြုသည်, အကြံပြုသည်|verb
申し込み|もうしこみ|application, entry, request|လျှောက်လွှာ, ဝင်ရောက်ယှဉ်ပြိုင်မှု, တောင်းဆိုမှု|noun
申出|もうしで|proposal, request, report|အဆိုပြုချက်, တောင်းဆိုချက်, အစီရင်ခံစာ|noun
申し出る|もうしでる|to report, to suggest, to offer|အစီရင်ခံသည်, အကြံပြုသည်, ကမ်းလှမ်းသည်|verb
申し分|もうしぶん|objection, shortcoming|ကန့်ကွက်ချက်, အားနည်းချက်|noun
盲点|もうてん|blind spot|မမြင်နိုင်သောနေရာ|noun
猛烈|もうれつ|violent, vehement, fierce|ပြင်းထန်သော, အားကြီးသော|adjective
藻掻く|もがく|to struggle, to wriggle|ရုန်းကန်သည်, လူးလွန့်သည်|verb
目録|もくろく|catalog, list|စာရင်း, ကတ်တလောက်|noun
目論見|もくろみ|plan, scheme, intention|အစီအစဉ်, ကြံစည်မှု, ရည်ရွယ်ချက်|noun
模型|もけい|model, dummy|မော်ဒယ်, ပုံတူ|noun
模索|もさく|groping for|စမ်းတဝါးဝါးရှာဖွေခြင်း|noun
若し|もし|if, in case, supposing|... လျှင်, ... ဆိုပါက|adverb
若しかしたら|もしかしたら|perhaps, maybe, by some chance|ဖြစ်နိုင်သည်, တစ်ခါတစ်ရံ|adverb
若しかして|もしかして|perhaps, possibly|ဖြစ်နိုင်သည်, ဖြစ်ကောင်းဖြစ်နိုင်သည်|adverb
若しかすると|もしかすると|perhaps, maybe, by some chance|ဖြစ်နိုင်သည်, တစ်ခါတစ်ရံ|adverb
若しくは|もしくは|or, otherwise|သို့မဟုတ်, တစ်နည်းအားဖြင့်|adverb
若しも|もしも|if|... လျှင်|adverb
齎らす|もたらす|to bring, to bring about|ယူဆောင်လာသည်, ဖြစ်ပေါ်စေသည်|verb
凭れる|もたれる|to lean against, to lie heavy (on the stomach)|မှီသည်, အစာမကြေဖြစ်သည်|verb
持ち|もち|hold, charge, durability|ကိုင်တွယ်မှု, တာဝန်, ကြာရှည်ခံမှု|noun
持ち切り|もちきり|hot topic, talk of the town|ရေပန်းစားနေသောအကြောင်းအရာ, လူပြောများနေသောအကြောင်းအရာ|noun
勿体ない|もったいない|wasteful, too good|ဖြုန်းတီးရာကျသော, အလွန်ကောင်းသော|adjective
以て|もって|with, by, by means of|ဖြင့်, အားဖြင့်|adverb
専ら|もっぱら|wholly, solely, entirely|တစ်ခုတည်း, သီးသန့်, လုံးဝ|adverb
持て成す|もてなす|to entertain, to make welcome|ဧည့်ခံသည်, ကြိုဆိုသည်|verb
持てる|もてる|to be popular, to be well liked|လူကြိုက်များသော, နှစ်သက်ခြင်းခံရသော|verb
基|もとい|basis, foundation|အခြေခံ, အရင်းခံ|noun
物置き|ものおき|storeroom|ပစ္စည်းထားခန်း|noun
物好き|ものずき|curiosity, eccentric|စူးစမ်းချင်စိတ်, ထူးဆန်းသော|adjective
物足りない|ものたりない|unsatisfied, unsatisfactory|မကျေနပ်သော, အားမရသော|adjective
最早|もはや|already, now|ပြီးသား, ယခု|adverb
模範|もはん|model, example|စံနမူနာ, ဥပမာ|noun
模倣|もほう|imitation, copying|အတုခိုးခြင်း|noun
揉める|もめる|to disagree, to dispute|သဘောမတူ, အငြင်းပွားသည်|verb
腿|もも|thigh, femur|ပေါင်, ပေါင်ရိုး|noun
催す|もよおす|to hold (a meeting), to feel (symptoms)|ကျင်းပသည် (အစည်းအဝေး), ခံစားရသည် (လက္ခဏာ)|verb
漏らす|もらす|to let leak, to reveal|စိမ့်ထွက်စေသည်, ဖော်ထုတ်သည်|verb
盛り上がる|もりあがる|to swell, to get excited, to rise|ဖောင်းကြွလာသည်, စိတ်လှုပ်ရှားလာသည်, မြင့်တက်လာသည်|verb
漏る|もる|to leak, to run out|စိမ့်သည်, ကုန်သွားသည်|verb
漏れる|もれる|to leak out, to escape, to be omitted|ပေါက်ကြားသည်, လွတ်မြောက်သည်, ကျန်ရစ်သည်|verb
脆い|もろい|brittle, fragile, tender-hearted|ကြွပ်ဆတ်သော, ပျက်လွယ်သော, စိတ်နုသော|adjective
もろに|もろに|completely, all the way|လုံးဝ, အပြည့်အဝ|adverb
問|もん|problem, question|ပြဿနာ, မေးခွန်း|noun
矢|や|arrow|မြား|noun
哉|や|question mark (in classical Japanese)|မေးခွန်းသင်္ကေတ (ရှေးဟောင်းဂျပန်)|noun
喧しい|やかましい|noisy, strict, fussy|ဆူညံသော, တင်းကျပ်သော, จู้จี้จุกจิก|adjective
野外|やがい|outdoors, open air|အပြင်ဘက်, လဟာပြင်|noun
軈て|やがて|before long, soon, at length|မကြာမီ, မကြာခင်, နောက်ဆုံးတွင်|adverb
夜行|やぎょう|night travel, night train|ညခရီး, ညရထား|noun
役職|やくしょく|post, managerial position|ရာထူး, စီမံခန့်ခွဲရေးရာထူး|noun
役立つ|やくだつ|to be useful, to be helpful|အသုံးဝင်သည်, အထောက်အကူပြုသည်|verb
役場|やくば|town hall, public office|မြို့တော်ခန်းမ, အစိုးရရုံး|noun
夜具|やぐ|bedding|အိပ်ရာ|noun
優|やさ|gentle, affectionate|နူးညံ့သော, ချစ်ခင်သော|adjective
屋敷|やしき|mansion, residence|အိမ်ကြီး, စံအိမ်|noun
養う|やしなう|to rear, to maintain, to cultivate|ပြုစုပျိုးထောင်သည်, ထိန်းသိမ်းသည်, စိုက်ပျိုးသည်|verb
社|やしろ|Shinto shrine|ရှင်တိုဘုရားကျောင်း|noun
野心|やしん|ambition, aspiration, treachery|ရည်မှန်းချက်, လောဘ, သစ္စာဖောက်မှု|noun
易い|やすい|easy|လွယ်ကူသော|adjective
安っぽい|やすっぽい|cheap-looking, tawdry, insignificant|ဈေးပေါသောပုံ, တန်ဖိုးမရှိသော|adjective
休める|やすめる|to rest, to suspend|အနားယူသည်, ဆိုင်းငံ့သည်|verb
野生|やせい|wild|တောရိုင်း|noun
矢鱈に|やたらに|randomly, recklessly, blindly|ကျပန်း, မဆင်မခြင်, လက်လွတ်စပယ်|adverb
夜中|やちゅう|all night, the whole night|တစ်ညလုံး|noun
奴|やっこ|fellow, guy (derogatory)|ကောင်, သူ (မလေးမစား)|noun
やっ付ける|やっつける|to beat, to attack|အနိုင်ယူသည်, တိုက်ခိုက်သည်|verb
矢っ張り|やっぱり|as expected, after all, still|ထင်တဲ့အတိုင်း, နောက်ဆုံးတော့, ยังคง|adverb
野党|やとう|opposition party|အတိုက်အခံပါတီ|noun
病|やまい|illness, disease|ဖျားနာခြင်း, ရောဂါ|noun
闇|やみ|darkness, the dark, black market|အမှောင်, တရားမဝင်ဈေးကွက်|noun
病む|やむ|to fall ill, to be ill|ဖျားသည်, နေမကောင်းဖြစ်သည်|verb
止むを得ない|やむをえない|cannot be helped, unavoidable|မတတ်နိုင်, ရှောင်လွှဲမရသော|adjective
稍|やや|a little, somewhat, slightly|အနည်းငယ်, တစေ့တစောင်း|adverb
ややこしい|ややこしい|puzzling, tangled, complicated|ရှုပ်ထွေးသော, နားလည်ရခက်သော|adjective
遣り通す|やりとおす|to carry through, to achieve, to complete|အဆုံးထိလုပ်ဆောင်သည်, အောင်မြင်အောင်လုပ်သည်, ပြီးမြောက်အောင်လုပ်သည်|verb
やり遂げる|やりとげる|to accomplish|ပြီးမြောက်အောင်လုပ်သည်|verb
遣る|やる|to do, to give (to inferiors)|လုပ်သည်, ပေးသည် (လက်အောက်ငယ်သားများအား)|verb
和らげる|やわらげる|to soften, to moderate, to relieve|ပျော့ပြောင်းစေသည်, လျှော့ချသည်, သက်သာစေသည်|verb
優位|ゆうい|predominance, superiority|သာလွန်မှု, အားသာချက်|noun
憂鬱|ゆううつ|depression, melancholy, gloom|စိတ်ဓာတ်ကျခြင်း, ဝမ်းနည်းခြင်း, မှောင်မိုက်ခြင်း|noun
有益|ゆうえき|beneficial, profitable|အကျိုးရှိသော, အမြတ်အစွန်းရှိသော|adjective
優越|ゆうえつ|supremacy, predominance|သာလွန်မှု, အထက်စီး|noun
勇敢|ゆうかん|bravery, heroism, gallantry|ရဲစွမ်းသတ္တိ, သူရဲကောင်းဆန်ခြင်း|adjective
有機|ゆうき|organic|ဩဂဲနစ်|noun
夕暮れ|ゆうぐれ|evening, twilight|ညနေ, ဆည်းဆာ|noun
融資|ゆうし|financing, loan|ဘဏ္ဍာငွေထောက်ပံ့ခြင်း, ချေးငွေ|noun
有する|ゆうする|to own, to be endowed with|ပိုင်ဆိုင်သည်, ပြည့်စုံသည်|verb
融通|ゆうずう|lending (money), adaptability, versatility|ငွေချေးခြင်း, လိုက်လျောညီထွေမှု, ဘက်စုံသုံးနိုင်မှု|noun
優勢|ゆうせい|superiority, superior power|သာလွန်မှု, အင်အားကြီးမားမှု|noun
優先|ゆうせん|preference, priority|ဦးစားပေးမှု|noun
誘導|ゆうどう|guidance, leading, induction|လမ်းညွှန်ခြင်း, ဦးဆောင်ခြင်း, သွင်းခြင်း|noun
優美|ゆうび|grace, refinement, elegance|ကျက်သရေ, ယဉ်ကျေးသိမ်မွေ့မှု, ခန့်ညားမှု|adjective
有望|ゆうぼう|promising, full of hope|အလားအလာကောင်းသော, မျှော်လင့်ချက်အပြည့်|adjective
遊牧|ゆうぼく|nomadism|ခြေသလုံးအိမ်တိုင်ဘဝ|noun
夕焼け|ゆうやけ|sunset|နေဝင်ဆည်းဆာ|noun
有力|ゆうりょく|influential, prominent, potent|သြဇာရှိသော, ထင်ရှားသော, အစွမ်းထက်သော|adjective
幽霊|ゆうれい|ghost, specter, apparition|တစ္ဆေ, သရဲ|noun
誘惑|ゆうわく|temptation, allurement, lure|ဖြားယောင်းမှု, ဆွဲဆောင်မှု|noun
揺さぶる|ゆさぶる|to shake, to jolt, to rock|လှုပ်ခါသည်, တုန်ခါစေသည်|verb
茹でる|ゆでる|to boil|ပြုတ်သည်|verb
ゆとり|ゆとり|reserve, room, time to spare|အပို, နေရာ, အချိန်ပို|noun
指差す|ゆびさす|to point at|လက်ညှိုးထိုးသည်|verb
弓|ゆみ|bow (weapon)|လေး (လက်နက်)|noun
揺らぐ|ゆらぐ|to swing, to sway, to shake|လှုပ်ခါသည်, ယိမ်းနွဲ့သည်, တုန်ခါသည်|verb
緩む|ゆるむ|to become loose, to slacken|လျော့ရဲလာသည်, ပျော့လာသည်|verb
緩める|ゆるめる|to loosen, to slow down|ဖြေလျှော့သည်, နှေးစေသည်|verb
緩やか|ゆるやか|lenient, gentle, gradual| lenient, နူးညံ့သော, တဖြည်းဖြည်း|adjective
世|よ|world, society, age, generation|ကမ္ဘာ, လူ့အဖွဲ့အစည်း, ခေတ်, မျိုးဆက်|noun
好い|よい|good|ကောင်းသော|adjective
要因|よういん|primary factor, main cause|အဓိကအချက်, အဓိကအကြောင်းရင်း|noun
溶液|ようえき|solution (liquid)|ဖျော်ရည်|noun
用件|ようけん|business, matter|ကိစ္စ, အကြောင်းအရာ|noun
養護|ようご|protection, nursing, protective care|ကာကွယ်စောင့်ရှောက်ခြင်း, ပြုစုခြင်း|noun
用紙|ようし|blank form, paper|ပုံစံစာရွက်, စက္ကူ|noun
様式|ようしき|style, form, pattern|ပုံစံ, ဟန်ပန်|noun
要する|ようする|to require, to need, to take|လိုအပ်သည်, လိုအပ်သည်|verb
要請|ようせい|request, demand, claim|တောင်းဆိုချက်, တောင်းဆိုမှု|noun
養成|ようせい|training, development|လေ့ကျင့်ပျိုးထောင်ခြင်း, ဖွံ့ဖြိုးတိုးတက်မှု|noun
様相|ようそう|aspect, appearance|အသွင်အပြင်, ပုံပန်းသဏ္ဌာန်|noun
用品|ようひん|articles, supplies, parts|ပစ္စည်းများ, ထောက်ပံ့ရေးပစ္စည်းများ|noun
洋風|ようふう|western style|အနောက်တိုင်းပုံစံ|noun
用法|ようほう|directions, rules of use|အသုံးပြုပုံ, အသုံးပြုရန်စည်းကမ်းများ|noun
要望|ようぼう|demand for, request|တောင်းဆိုမှု, တောင်းဆိုချက်|noun
余暇|よか|leisure, spare time|အားလပ်ချိန်|noun
予感|よかん|premonition, presentiment|ရှေ့ပြေးနိမိတ်, စိတ်တွင်ကြိုတင်သိမြင်ခြင်း|noun
余興|よきょう|side show, entertainment|ဘေးထွက်ဖျော်ဖြေမှု, ဖျော်ဖြေရေး|noun
預金|よきん|deposit, bank account|ငွေသွင်းခြင်း, ဘဏ်စာရင်း|noun
抑圧|よくあつ|oppression, suppression, restraint|ဖိနှိပ်မှု, နှိမ်နင်းမှု|noun
浴室|よくしつ|bathroom, bath|ရေချိုးခန်း|noun
抑制|よくせい|suppression, control|နှိမ်နင်းမှု, ထိန်းချုပ်မှု|noun
欲深い|よくふかい|greedy|လောဘကြီးသော|adjective
欲望|よくぼう|desire, appetite|ဆန္ဒ, တပ်မက်မှု|noun
寄こす|よこす|to send, to forward|ပို့သည်, ပေးပို့သည်|verb
横綱|よこづな|sumo grand champion|ဆူမိုချန်ပီယံကြီး|noun
葦|よし|reed, bulrush|ကျူပင်|noun
善し悪し|よしあし|good or bad, merits or demerits|အကောင်းအဆိုး, အကျိုးအပြစ်|noun
予想|よそう|expectation, prediction, forecast|မျှော်လင့်ချက်, ခန့်မှန်းချက်|noun
余所見|よそみ|looking away, looking aside|ဘေးသို့ကြည့်ခြင်း|noun
余地|よち|place, room, margin, scope|နေရာ, အခန်း, အနားသတ်, အခွင့်အလမ်း|noun
依って|よって|therefore, consequently, accordingly|ထို့ကြောင့်, အကျိုးဆက်အားဖြင့်|adverb
余程|よっぽど|very, greatly, much, quite|အလွန်, အများကြီး, တော်တော်|adverb
与党|よとう|ruling party, government party|အာဏာရပါတီ, အစိုးရပါတီ|noun
呼び止める|よびとめる|to call to a halt, to challenge|ရပ်တန့်ရန်ခေါ်သည်, စိန်ခေါ်သည်|verb
夜更かし|よふかし|staying up late, nighthawk|ညဉ့်နက်သည်အထိနေခြင်း, ညစောင့်ငှက်|noun
夜更け|よふけ|late at night|ညဉ့်နက်|noun
読み上げる|よみあげる|to read out loud|အသံကျယ်ကျယ်ဖတ်သည်|verb
寄り掛かる|よりかかる|to lean against, to rely on|မှီသည်, အားကိုးသည်|verb
宜しく|よろしく|well, best regards, please treat me well|ကောင်းစွာ, လေးစားစွာဖြင့်, ကျွန်ုပ်ကို ကောင်းစွာဆက်ဆံပါ|adverb
弱まる|よわまる|to weaken, to abate|အားနည်းလာသည်, လျော့ပါးသွားသည်|verb
弱める|よわめる|to weaken|အားနည်းစေသည်|verb
弱る|よわる|to weaken, to be troubled, to be perplexed|အားနည်းသည်, ဒုက္ခရောက်သည်, စိတ်ရှုပ်သည်|verb
来場|らいじょう|attendance|တက်ရောက်ခြင်း|noun
酪農|らくのう|dairy farming|နို့ထွက်ပစ္စည်းမွေးမြူရေး|noun
落下|らっか|fall, drop, descent|ပြုတ်ကျခြင်း, ကျဆင်းခြင်း|noun
楽観|らっかん|optimism|အကောင်းမြင်ဝါဒ|noun
濫用|らんよう|abuse, misuse, misappropriation|အလွဲသုံးစားလုပ်ခြင်း, အလွဲသုံးခြင်း|noun
理屈|りくつ|theory, reason, logic|သီအိုရီ, အကြောင်းပြချက်, ယုတ္တိ|noun
利根|りこん|intelligence|ဉာဏ်ရည်|noun
利子|りし|interest (bank)|အတိုး (ဘဏ်)|noun
利潤|りじゅん|profit, returns|အမြတ်, ပြန်ရငွေ|noun
理性|りせい|reason, sense|အကျိုးအကြောင်း, အသိ|noun
利息|りそく|interest (bank)|အတိုး (ဘဏ်)|noun
立体|りったい|solid body, three-dimensional object|အစိုင်အခဲ, သုံးဘက်မြင်အရာဝတ္ထု|noun
立法|りっぽう|legislation, lawmaking|ဥပဒေပြုခြင်း|noun
利点|りてん|advantage, point in favor|အားသာချက်, အကျိုးရှိသောအချက်|noun
略語|りゃくご|abbreviation, acronym|အတိုကောက်, အတိုကောက်စကားလုံး|noun
略奪|りゃくだつ|pillage, plunder, looting|လုယက်ခြင်း, သိမ်းပိုက်ခြင်း|noun
流|りゅう|style, method, manner|ဟန်, နည်းလမ်း, ပုံစံ|noun
流通|りゅうつう|circulation, distribution|လည်ပတ်မှု, ဖြန့်ဖြူးမှု|noun
了|りょう|finish, completion, understanding|ပြီးสิ้นခြင်း, ပြီးမြောက်ခြင်း, နားလည်မှု|noun
料|りょう|material, charge, fee|ပစ္စည်း, အဖိုးအခ, နှုန်းထား|noun
領域|りょういき|area, domain, territory, field|ဧရိယာ, နယ်ပယ်, ပိုင်နက်|noun
了解|りょうかい|comprehension, consent, understanding|နားလည်မှု, သဘောတူညီချက်|noun
領海|りょうかい|territorial waters|ပိုင်နက်ရေပြင်|noun
両極|りょうきょく|both extremities, both poles|စွန်းနှစ်ဖက်, ဝင်ရိုးစွန်းနှစ်ခု|noun
良好|りょうこう|favorable, satisfactory|ကောင်းမွန်သော, ကျေနပ်ဖွယ်|adjective
良識|りょうしき|good sense|အသိတရား|noun
良質|りょうしつ|good quality, superior quality|အရည်အသွေးကောင်း, သာလွန်အရည်အသွေး|noun
了承|りょうしょう|acknowledgement, understanding|အသိအမှတ်ပြုခြင်း, နားလည်မှု|noun
良心|りょうしん|conscience|ကိုယ်ကိုကိုယ်သိသောစိတ်|noun
領地|りょうち|territory, dominion|ပိုင်နက်, နယ်မြေ|noun
領土|りょうど|dominion, territory, possession|ပိုင်နက်, နယ်မြေ, ပိုင်ဆိုင်မှု|noun
両立|りょうりつ|compatibility, coexistence|လိုက်ဖက်ညီမှု, အတူယှဉ်တွဲနေထိုင်မှု|noun
旅客|りょかく|passenger (transport)|ခရီးသည် (သယ်ယူပို့ဆောင်ရေး)|noun
旅券|りょけん|passport|နိုင်ငံကူးလက်မှတ်|noun
履歴|りれき|personal history, background, career|ကိုယ်ရေးရာဇဝင်, နောက်ခံ, အသက်မွေးဝမ်းကျောင်း|noun
理論|りろん|theory|သီအိုရီ|noun
輪|りん|ring, wheel, counter for wheels and flowers|ကွင်း, ဘီး, ဘီးနှင့်ပန်းများအတွက်ရေတွက်ပုံ|noun
林業|りんぎょう|forestry|သစ်တောလုပ်ငန်း|noun
類似|るいじ|analogy, resemblance|အလားတူ, တူညီမှု|noun
類推|るいすい|analogy, inference by analogy|အလားတူမှန်းဆခြင်း|noun
冷酷|れいこく|cruelty, coldheartedness, ruthless|ရက်စက်မှု, စိတ်နှလုံးမာကျောခြင်း, ကရုဏာမဲ့|adjective
冷蔵|れいぞう|cold storage, refrigeration|အအေးခန်း, ရေခဲသေတ္တာ|noun
冷淡|れいたん|coolness, indifference|အေးစက်ခြင်း, ဂရုမစိုက်ခြင်း|adjective
恋愛|れんあい|love, passion, affection|အချစ်, တပ်မက်မှု, ချစ်ခင်မှု|noun
連休|れんきゅう|consecutive holidays|ဆက်တိုက်ရုံးပိတ်ရက်များ|noun
連日|れんじつ|every day, prolonged|နေ့တိုင်း, ရက်ဆက်|adverb
連中|れんじゅう|colleagues, company, a lot|လုပ်ဖော်ကိုင်ဖက်များ, အဖွဲ့, အများကြီး|noun
連帯|れんたい|solidarity|စည်းလုံးညီညွတ်မှု|noun
連邦|れんぽう|commonwealth, federation of states|ဓနသဟာယ, ပြည်ထောင်စု|noun
連盟|れんめい|league, union, alliance|အဖွဲ့ချုပ်, သမဂ္ဂ, မဟာမိတ်|noun
老衰|ろうすい|senility, senile decay|အိုမင်းမစွမ်းဖြစ်ခြင်း, ဇရာ|noun
朗読|ろうどく|reading aloud, recitation|အသံကျယ်ကျယ်ဖတ်ခြင်း, ရွတ်ဆိုခြင်း|noun
浪費|ろうひ|waste, extravagance|ဖြုန်းတီးခြင်း, အလွန်အကျွံသုံးစွဲခြင်း|noun
労力|ろうりょく|labor, effort, toil, trouble|လုပ်အား, ကြိုးစားအားထုတ်မှု, ပင်ပန်းမှု|noun
碌な|ろくな|satisfactory, decent|ကျေနပ်ဖွယ်, သင့်တင့်သော|adjective
碌に|ろくに|well, enough, sufficiently (with neg. verb)|ကောင်းစွာ, လုံလောက်စွာ (အငြင်းနှင့်တွဲသုံး)|adverb
露骨|ろこつ|frank, blunt, plain, outspoken|ပွင့်လင်းသော, တဲ့တိုး, ရိုးရှင်းသော|adjective
論議|ろんぎ|discussion, debate|ဆွေးနွေးခြင်း, စကားစစ်ထိုးခြင်း|noun
論理|ろんり|logic|ယုတ္တိဗေဒ|noun
和|わ|sum, harmony, peace|ပေါင်းလဒ်, သဟဇာတဖြစ်မှု, ငြိမ်းချမ်းရေး|noun
我がまま|わがまま|selfishness, egoism, willfulness|အတ္တကြီးခြင်း, တစ်ကိုယ်ကောင်းဆန်ခြင်း|noun
枠|わく|frame, border, framework|ဘောင်, အနားသတ်|noun
惑星|わくせい|planet|ဂြိုဟ်|noun
技|わざ|art, technique, skill|အနုပညာ, နည်းပညာ, ကျွမ်းကျင်မှု|noun
態と|わざと|on purpose|တမင်တကာ|adverb
態々|わざわざ|expressly, specially, purposefully|တကူးတက, အထူးသဖြင့်|adverb
煩わしい|わずらわしい|troublesome, annoying, complicated|စိတ်ရှုပ်စရာ, စိတ်အနှောင့်အယှက်ဖြစ်စရာ, ရှုပ်ထွေးသော|adjective
渡り鳥|わたりどり|migratory bird|ရွှေ့ပြောင်းငှက်|noun
詫び|わび|apology|တောင်းပန်ခြင်း|noun
和風|わふう|Japanese style|ဂျပန်ပုံစံ|noun
和文|わぶん|Japanese text|ဂျပန်စာသား|noun
藁|わら|straw|ကောက်ရိုး|noun
割合に|わりあいに|comparatively|နှိုင်းယှဉ်လျှင်|adverb
割り当て|わりあて|allotment, assignment, quota|ခွဲဝေမှု, တာဝန်ပေးအပ်မှု, ခွဲတမ်း|noun
割り込む|わりこむ|to cut in, to interrupt|ကြားဖြတ်ဝင်သည်, နှောင့်ယှက်သည်|verb
割り算|わりざん|division (math)|စားခြင်း (သင်္ချာ)|noun
割引き|わりびき|discount, reduction, rebate|လျှော့ဈေး, လျှော့ချခြင်း|noun
悪者|わるもの|bad fellow, villain, scoundrel|လူဆိုး, လူယုတ်မာ|noun
アイデア|アイデア|idea|အကြံဉာဏ်|noun
アクセル|アクセル|accelerator|အရှိန်မြှင့်ခလုတ်|noun
アップ|アップ|up|အပေါ်|noun
アプローチ|アプローチ|approach|ချဉ်းကပ်မှု|noun
アマチュア|アマチュア|amateur|အပျော်တမ်း|noun
アラブ|アラブ|Arab|အာရပ်|noun
アルカリ|アルカリ|alkali|အယ်လကာလီ|noun
アルミ|アルミ|aluminum|အလူမီနီယမ်|noun
アワー|アワー|hour|နာရီ|noun
アンケート|アンケート|questionnaire, survey|မေးခွန်းလွှာ, စစ်တမ်း|noun
アンコール|アンコール|encore|ထပ်ဆင့်တောင်းဆိုခြင်း|noun
イエス|イエス|Jesus, yes|ယေရှု, ဟုတ်ကဲ့|noun
インターチェンジ|インターチェンジ|interchange|လမ်းဆုံလမ်းခွ|noun
インターナショナル|インターナショナル|international|နိုင်ငံတကာ|adjective
インターフォン|インターフォン|intercom|အင်တာကွမ်း|noun
インテリ|インテリ|intellectual|ပညာတတ်|noun
インフォメーション|インフォメーション|information|သတင်းအချက်အလက်|noun
インフレ|インフレ|inflation|ငွေကြေးဖောင်းပွမှု|noun
ウェートレス|ウェートレス|waitress|စားပွဲထိုးမ|noun
エアメール|エアメール|airmail|လေကြောင်းစာ|noun
エレガント|エレガント|elegant|ခန့်ညားသော|adjective
エンジニア|エンジニア|engineer|အင်ဂျင်နီယာ|noun
オーケー|オーケー|OK|အိုကေ|adverb
オートマチック|オートマチック|automatic|အလိုအလျောက်|adjective
オープン|オープン|open|ဖွင့်သည်|noun
オリエンテーション|オリエンテーション|orientation|မိတ်ဆက်ခြင်း|noun
オレンジ|オレンジ|orange|လိမ္မော်သီး|noun
オンライン|オンライン|online|အွန်လိုင်း|noun
カーペット|カーペット|carpet|ကော်ဇော|noun
カクテル|カクテル|cocktail|ကော့တေး|noun
カット|カット|cut, cutting|ဖြတ်တောက်ခြင်း|noun
カテゴリー|カテゴリー|category|အမျိုးအစား|noun
カムバック|カムバック|comeback|ပြန်လည်ရောက်ရှိလာခြင်း|noun
カメラマン|カメラマン|caman|ဓာတ်ပုံဆရာ|noun
カルテ|カルテ|clinical records|ဆေးမှတ်တမ်း|noun
カンニング|カンニング|cunning, cheating|ကောက်ကျစ်ခြင်း, လိမ်လည်ခြင်း|noun
ガイド|ガイド|tour guide|ခရီးသွားလမ်းညွှန်|noun
ガイドブック|ガイドブック|guidebook|လမ်းညွှန်စာအုပ်|noun
ガレージ|ガレージ|garage|ကားဂိုဒေါင်|noun
キャッチ|キャッチ|catch|ဖမ်းခြင်း|noun
キャリア|キャリア|career|အသက်မွေးဝမ်းကျောင်း|noun
クイズ|クイズ|quiz|ဉာဏ်စမ်းပဟေဠိ|noun
クラブ|クラブ|club|ကလပ်|noun
クレーン|クレーン|crane|ကရိန်း|noun
グラフ|グラフ|graph|ဂရပ်|noun
グレー|グレー|grey, gray|မီးခိုးရောင်|noun
ゲスト|ゲスト|guest|ဧည့်သည်|noun
コーナー|コーナー|corner|ထောင့်|noun
コマーシャル|コマーシャル|commercial|ကြော်ငြာ|noun
コミュニケーション|コミュニケーション|communication|ဆက်သွယ်ရေး|noun
コメント|コメント|comment|မှတ်ချက်|noun
コンタクト|コンタクト|contact, contact lens|အဆက်အသွယ်, မျက်ကပ်မှန်|noun
コンテスト|コンテスト|contest|ပြိုင်ပွဲ|noun
コントラスト|コントラスト|contrast|ဆန့်ကျင်ဘက်|noun
コントロール|コントロール|control|ထိန်းချုပ်မှု|noun
コンパス|コンパス|compass|သံလိုက်အိမ်မြှောင်|noun
サイクル|サイクル|cycle|စက်ဝန်း|noun
サイズ|サイズ|size|အရွယ်အစား|noun
サボる|サボる|to be truant, to be idle, to skip (work/class)|ကျောင်းပြေးသည်, အလုပ်ခိုသည်|verb
サンキュー|サンキュー|thank you|ကျေးဇူးတင်ပါတယ်|noun
サンタクロース|サンタクロース|Santa Claus|စန်တာကလော့စ်|noun
シート|シート|seat, sheet|ထိုင်ခုံ, အခင်း|noun
システム|システム|system|စနစ်|noun
シック|シック|chic, stylish|စတိုင်ကျသော|adjective
シナリオ|シナリオ|scenario|ဇာတ်လမ်းဇာတ်ညွှန်း|noun
ショー|ショー|show|ပြပွဲ|noun
ショック|ショック|shock|ထိတ်လန့်ခြင်း|noun
ジーパン|ジーパン|jeans|ဂျင်းဘောင်းဘီ|noun
ジャズ|ジャズ|jazz|ဂျက်စ်ဂီတ|noun
ジャンパー|ジャンパー|jacket, jumper|ဂျာကင်အင်္ကျီ|noun
ジャンプ|ジャンプ|jump|ခုန်သည်|noun
ジャンボ|ジャンボ|jumbo|ကြီးမားသော|adjective
ジャンル|ジャンル|genre|အမျိုးအစား|noun
スタジオ|スタジオ|studio|စတူဒီယို|noun
スチーム|スチーム|steam|ရေနွေးငွေ့|noun
ストライキ|ストライキ|strike|သပိတ်မှောက်ခြင်း|noun
ストレス|ストレス|stress|စိတ်ဖိစီးမှု|noun
ストロー|ストロー|straw|ပိုက်|noun
ストロボ|ストロボ|strobe|စထရိုဘိုမီး|noun
スピード|スピード|speed|အရှိန်|noun
スプリング|スプリング|spring|စပရင်|noun
スペース|スペース|space|နေရာ|noun
スポーツカー|スポーツカー|sports car|အားကစားကား|noun
スラックス|スラックス|slacks|ဘောင်းဘီ|noun
セール|セール|sale|ဈေးရောင်းပွဲတော်|noun
セクション|セクション|section|အပိုင်း|noun
セックス|セックス|sex, sexual intercourse|လိင်, လိင်ဆက်ဆံခြင်း|noun
セレモニー|セレモニー|ceremony|အခမ်းအနား|noun
センス|センス|good sense, taste|အာရုံခံစားမှု, အရသာ|noun
ゼリー|ゼリー|jelly|ဂျယ်လီ|noun
ソース|ソース|source, sauce|အရင်းအမြစ်, ဆော့စ်|noun
ソックス|ソックス|socks|ခြေအိတ်|noun
ソロ|ソロ|solo|တစ်ကိုယ်တော်|noun
タイトル|タイトル|title|ခေါင်းစဉ်|noun
タイピスト|タイピスト|typist|လက်နှိပ်စက်စာရေး|noun
タイマー|タイマー|timer|အချိန်တိုင်းကိရိယာ|noun
タイミング|タイミング|timing|အချိန်ကိုက်|noun
タイム|タイム|time|အချိန်|noun
タイムリー|タイムリー|timely|အချိန်မီ|adjective
タイヤ|タイヤ|tire, tyre|ကားဘီး|noun
タイル|タイル|tile|ကြွေပြား|noun
タレント|タレント|talent, star, personality|အရည်အချင်း, ကြယ်ပွင့်, ပုဂ္ဂိုလ်|noun
タワー|タワー|tower|မျှော်စင်|noun
ダース|ダース|dozen|တစ်ဒါဇင်|noun
ダウン|ダウン|down|အောက်|noun
ダブる|ダブる|to overlap, to repeat a school year|ထပ်သည်, ကျောင်းတစ်နှစ်ပြန်တက်သည်|verb
ダンプ|ダンプ|dump|စွန့်ပစ်သည်|noun
チームワーク|チームワーク|teamwork|အဖွဲ့လိုက်လုပ်ဆောင်မှု|noun
チェンジ|チェンジ|change|ပြောင်းလဲခြင်း|noun
チャイム|チャイム|chime|ခေါင်းလောင်းသံ|noun
チャンネル|チャンネル|channel|ချန်နယ်|noun
ティッシュペーパー|ティッシュペーパー|tissue paper|တစ်ရှူးစက္ကူ|noun
テレックス|テレックス|telex|တယ်လက်စ်|noun
データ|データ|data|အချက်အလက်|noun
デコレーション|デコレーション|decoration|အလှဆင်ခြင်း|noun
デザート|デザート|dessert|အချိုပွဲ|noun
デザイン|デザイン|design|ဒီဇိုင်း|noun
デッサン|デッサン|rough sketch|ပုံကြမ်း|noun
デモンストレーション|デモンストレーション|demonstration|သရုပ်ပြခြင်း|noun
トーン|トーン|tone|အသံနေအသံထား|noun
トラブル|トラブル|trouble|ပြဿနာ|noun
トランジスター|トランジスター|transistor|ထရန်စစ္စတာ|noun
ドライ|ドライ|dry|ခြောက်သွေ့သော|adjective
ドライクリーニング|ドライクリーニング|dry cleaning|အခြောက်လျှော်|noun
ドライバー|ドライバー|driver, screwdriver|ယာဉ်မောင်း, ဝက်အူလှည့်|noun
ドライブイン|ドライブイン|drive-in|ကားရပ်နားစားသောက်ဆိုင်|noun
ドリル|ドリル|drill|လေ့ကျင့်ခန်း|noun
ナイター|ナイター|night game|ညဘက်ကစားပွဲ|noun
ナプキン|ナプキン|napkin|လက်သုတ်ပုဝါ|noun
ナンセンス|ナンセンス|nonsense|အဓိပ္ပာယ်မရှိသော|noun
ニュー|ニュー|new|အသစ်|adjective
ニュアンス|ニュアンス|nuance|အsubtleကွဲပြားမှု|noun
ネガ|ネガ|negative (photographic)|နဂေးတစ်ဖလင်|noun
ノイローゼ|ノイローゼ|neurosis|အာရုံကြောရောဂါ|noun
ハンガー|ハンガー|hanger (coat)|အင်္ကျီချိတ်|noun
バー|バー|bar|ဘား|noun
バッジ|バッジ|badge|တံဆိပ်|noun
バット|バット|bat|ရိုက်တံ|noun
パジャマ|パジャマ|pajamas|ညဝတ်အင်္ကျီ|noun
パチンコ|パチンコ|pachinko|ပန်ချာပူ|noun
パトカー|パトカー|patrol car|ကင်းလှည့်ကား|noun
パンク|パンク|puncture, punk|ဘီးပေါက်ခြင်း, ပန့်ခ်|noun
ヒント|ヒント|hint|အရိပ်အမြွက်|noun
ビールス|ビールス|virus|ဗိုင်းရပ်စ်|noun
ビジネス|ビジネス|business|စီးပွားရေး|noun
ファイト|ファイト|fight|တိုက်ပွဲ|noun
ファイル|ファイル|file|ဖိုင်|noun
ファン|ファン|fan|ပရိသတ်|noun
フィルター|フィルター|filter|စစ်ထုတ်ကိရိယာ|noun
フェリー|フェリー|ferry|ကူးတို့သင်္ဘော|noun
フォーム|フォーム|form, foam|ပုံစံ, အမြှုပ်|noun
フロント|フロント|front|ရှေ့|noun
ブーツ|ブーツ|boots|ဘွတ်ဖိနပ်|noun
ブーム|ブーム|boom|ခေတ်စားမှု|noun
ブザー|ブザー|buzzer|ဘဲလ်|noun
ブルー|ブルー|blue|အပြာ|noun
ベース|ベース|base, bass|အခြေစိုက်စခန်း, ဘေ့စ်|noun
ベスト|ベスト|best, vest|အကောင်းဆုံး, လက်ပြတ်အင်္ကျီ|noun
ベストセラー|ベストセラー|best-seller|အရောင်းရဆုံး|noun
ペア|ペア|pair|အတွဲ|noun
ホース|ホース|hose|ရေပိုက်|noun
ホール|ホール|hall, hole|ခန်းမ, အပေါက်|noun
ボイコット|ボイコット|boycott|သပိတ်မှောက်ခြင်း|noun
ボルト|ボルト|volt, bolt|ဗို့, ဘော့|noun
ポーズ|ポーズ|pause, pose|ခေတ္တရပ်ခြင်း, ပို့စ်|noun
ポイント|ポイント|point|အမှတ်|noun
ポジション|ポジション|position|အနေအထား|noun
ポット|ポット|pot|အိုး|noun
ポンプ|ポンプ|pump|ပန့်|noun
マーク|マーク|mark|အမှတ်အသား|noun
マスコミ|マスコミ|mass communication|အစုလိုက်အပြုံလိုက်ဆက်သွယ်ရေး|noun
マッサージ|マッサージ|massage|နှိပ်နယ်ခြင်း|noun
ミスプリント|ミスプリント|misprint|ပုံနှိပ်မှားခြင်း|noun
ミセス|ミセス|Mrs.|အိမ်ထောင်ရှင်အမျိုးသမီး|noun
ミュージック|ミュージック|music|ဂီတ|noun
ミリ|ミリ|milli- (10^-3)|မီလီ|noun
ムード|ムード|mood|ခံစားချက်|noun
メーカー|メーカー|maker, manufacturer|ထုတ်လုပ်သူ|noun
メッセージ|メッセージ|message|သတင်းစကား|noun
メディア|メディア|media|မီဒီယာ|noun
メロディー|メロディー|melody|သံစဉ်|noun
モーテル|モーテル|motel|မိုတယ်|noun
モニター|モニター|monitor|မော်နီတာ|noun
ヤング|ヤング|young|လူငယ်|noun
ユニーク|ユニーク|unique|ထူးခြားသော|adjective
ユニフォーム|ユニフォーム|uniform|ယူနီဖောင်း|noun
ライス|ライス|rice|ထမင်း|noun
ラベル|ラベル|label|တံဆိပ်|noun
ランプ|ランプ|lamp, light|မီးအိမ်, မီး|noun
ルーズ|ルーズ|loose|ပေါ့လျော့သော|adjective
ルール|ルール|rule|စည်းကမ်း|noun
レース|レース|race, lace|ပြိုင်ပွဲ, ဇာ|noun
レギュラー|レギュラー|regular|ပုံမှန်|adjective
レクリエーション|レクリエーション|recreation|အပန်းဖြေမှု|noun
レッスン|レッスン|lesson|သင်ခန်းစာ|noun
レディー|レディー|lady|အမျိုးသမီး|noun
レバー|レバー|lever, liver|လီဗာ, အသည်း|noun
レンジ|レンジ|range, stove|အကွာအဝေး, မီးဖို|noun
レンタカー|レンタカー|rental car|ငှားရမ်းသောကား|noun
レントゲン|レントゲン|X-ray|ဓာတ်မှန်|noun
ロープ|ロープ|rope|ကြိုး|noun
ローマ字|ローマじ|Roman letters, romaji|ရောမအက္ခရာ|noun
ロマンチック|ロマンチック|romantic|ရိုမန်းတစ်|adjective
ワット|ワット|watt|ဝပ်|noun
